Afore	Trước
Agate	Mã não
Apply	Áp dụng
Argue	Tranh cãi
Array	Mảng
Black	Màu đen
Blast	Vụ nổ
Brave	Can đảm
Brown	màu nâu
Claim	Yêu cầu
Climb	Trèo
Corgi	Chó Corgi
Cramp	Chuột rút
Crown	Vương miện
Diary	Nhật ký
Usage	Sử dụng
Divvy	Chia rẽ
Downy	Lông măng
Drain	Làm khô hạn
Usage	Sử dụng
Dummy	Hình nộm
Eagle	chim ưng
Earth	Trái đất
Eject	Đẩy ra
Entry	Lối vào
Equip	Trang bị
Exert	Gắng sức
Usage	Sử dụng
Usage	Sử dụng
Fibre	Chất xơ
First	Đầu tiên
Fluid	Dịch
Frame	Khung
Front	Sự trơ trẽn
Genus	Chi
Usage	Sử dụng
Grape	Giống nho
Green	màu xanh lá
Heavy	Nặng
Hello	xin chào
Horse	Ngựa
House	căn nhà
Hunch	Gù
Hymen	Thần hôn nhân
Jesus	Chúa Giêsu
Judge	Trọng tài
Latch	Chốt cửa
Legal	Hợp pháp
Usage	Sử dụng
Loose	Lỏng lẻo
Loser	Kẻ thua cuộc
Magma	dung nham
Mixed	Trộn
Navel	Lỗ rốn
Nerve	Thần kinh
Pearl	Ngọc trai
Pedal	Bàn đạp
Piece	Mảnh
Piggy	Heo con
Plank	Tấm ván
Usage	Sử dụng
Pools	Hồ bơi
Pride	Tự hào
Quite	Khá
Radio	Đài
Refer	Tham khảo
Rough	Gồ ghề
Round	Tròn
Round	Tròn
Salsa	điệu Salsa
Saute	Áp chảo
Sedge	Cói
Shape	Hình dạng
Shock	Sốc
Short	Ngắn
Shown	Cho xem
Sight	Thị giác
Slimy	Nhầy nhụa
Small	Nhỏ
Smirk	Nhếch mép
Sneak	Quay lén
Solar	Hệ mặt trời
Spark	Tia lửa
Speed	Tốc độ
Spice	Gia vị
Stage	Sân khấu
Steal	Ăn cắp
Store	Cửa hàng
Sweet	Kẹo
Sweet	Kẹo
Tally	Kiếm điểm
Taste	Nếm
Three	Ba
Track	Theo dõi
Ulcer	Vết loét
Usage	Sử dụng
Usage	Sử dụng
Vocal	Thanh nhạc
Voter	Cử tri
Waist	Thắt lưng
Waste	Rác thải
Wreck	Xác tàu
Yeast	Men
Zebra	Ngựa rằn
acted	đã hành động
Acton	Hành động
Actor	Diễn viên nam
actos	hành động
actus	hành động
acute	nhọn
adage	câu ngạn ngữ
adagy	thích thú
adays	một ngày
adapt	thích nghi
adaty	ngoan cố
added	thêm
adder	người bổ sung
addle	ung hư
adead	một người chết
adeep	tuân thủ
Adell	Một thung lũng nhỏ
adept	lão luyện
adfix	tiền tố
adits	quảng cáo
adjag	bổ sung
adman	người quảng cáo
admin	quản trị viên
admit	thừa nhận
admix	quản trị viên
adnex	phụ lục
adopt	nhận nuôi
Adore	Yêu thích
adorn	tô điểm
adoze	uống rượu
adsum	sự hấp dẫn
adult	người lớn
adure	tôn nghiêm
Aello	Chào
aemia	thiếu máu
aface	bề ngoài
afear	nỗi sợ
affix	đóng dấu
afire	Một đám cháy
aflow	một dòng chảy
afore	trước
afret	lo lắng
after	sau
again	lần nữa
agars	thạch
Agate	Mã não
Agave	Cây thùa
agaze	kinh ngạc
agend	nghị sự
agene	tuổi mới lớn
agent	đại lý
aggry	sự kết hợp
aggro	Hung bạo
aggur	bồ bịch
agile	nhanh nhẹn
aging	sự lão hóa
agism	chủ nghĩa kích động
aglow	nhanh chóng
agoge	đau khổ
agoho	trước đây
agony	đau đớn
agree	đồng ý
agush	phấn khích
agust	mạnh mẽ
ahead	phía trước
aheap	một đống
ahind	phía sau
ahint	một gợi ý
ahold	kìa
ahunt	một cuộc săn bắn
aided	hỗ trợ
Aides	Phụ tá
Aidit	Viện trợ
aiery	thoáng mát
ailed	ốm yếu
aimed	nhằm vào
aimer	người ngắm bắn
aioli	Bơ
ayond	xa hơn
aired	được phát sóng
airer	máy bay
aisle	lối đi
ajari	sư thầy
aknee	đầu gối
aknow	một bí quyết
alack	thiếu
Alair	Một hang ổ
Alake	Một hồ nước
Aland	Một vùng đất
alarm	báo thức
albus	xe buýt
alday	trong ngày
Alder	Già hơn
aleak	lổ thủng
aleft	bên trái
alert	báo động
alfas	bí danh
algae	tảo
algal	tảo
alias	bí danh
alibi	bằng chứng ngoại phạm
alien	người ngoài hành tinh
aliet	bí danh
alife	một cuộc sống
alifs	bí danh
align	căn chỉnh
alike	như nhau
alist	một danh sách
ality	đồng minh
alive	còn sống
allay	xoa dịu
Alley	Ngõ
Allin	Tất cả trong
Allis	Tất cả là
Allys	Đồng minh
alloy	hợp kim
allot	phân bổ
allow	cho phép
aloft	trên cao
alone	một mình
along	dọc theo
aloof	đứng cách xa
aloud	lớn tiếng
alout	ra ngoài
altar	bàn thờ
alter	thay đổi
alure	đồng ý
alway	luôn
amalg	hỗn hống
amass	tích lũy
amate	một người bạn
amaze	kinh ngạc
Amber	Hổ phách
Amble	Đi thong thả
ameed	sửa chữa
Amend	Sửa đổi
amene	người mỹ
amess	một mớ hỗn độn
amies	quân đội
amine	amin
amirs	bạn trai
amiss	không ổn
Amity	Tình thân
amlet	bùa hộ mệnh
amnia	chứng mất trí nhớ
amole	một nốt ruồi
among	giữa
amour	tình yêu
amove	một nước đi
ample	Phong phú
amply	đủ
amuck	mê muội
amuse	giải trí
amuze	làm say mê
ancle	chiếc cúp
anear	cây cỏ khô
anele	cây an xoa
anend	kết thúc
anent	không phải
Angel	Thiên thần
anger	Sự phẫn nộ
Angle	Góc
angry	tức giận
angst	sợ
anime	phim hoạt hình
anise	cây hồi
ankle	mắt cá
ankus	mắt cá chân
anlas	bản đồ
annex	Phụ lục
annoy	làm phiền
annot	chú thích
annul	bãi bỏ
anode	cực dương
anomy	dị thường
Anthe	Một sự
antic	chống đối
antis	chống lại
antsy	có kiến
anury	cơn thịnh nộ
anvil	cái đe
aorta	động mạch chủ
apair	một đôi
apart	riêng biệt
apast	một quá khứ
aphid	rệp
apian	nuôi ong
apism	thuyết ngụy biện
apnea	ngưng thở
apods	apod
appal	bổ sung
appar	ứng dụng
Apple	quả táo
apply	áp dụng
appro	chấp thuận
April	tháng tư
apron	tạp dề
aptly	khéo léo
Apure	Xin lỗi
aquas	nước biển
arabs	người nhện
arace	một cuộc đua
arach	con nhện
arage	một cơn thịnh nộ
arake	cái cào
arbor	cây thông
arced	bắt buộc
ardor	nhiệt huyết
aread	hạt
areae	khu vực
areas	khu vực
Areca	Cau
areek	cau có
arefy	làm hài lòng
arend	uốn cong
arent	không
arere	con ong
arest	thạch anh
Areus	Là chúng ta
Argia	Đau khớp
argle	tranh luận
argot	tranh cãi
argue	tranh cãi
Arhat	La hán
Aries	Bạch Dương
ariot	một cuộc bạo loạn
arise	nảy sinh
arist	bình nóng lạnh
armed	vũ trang
armor	áo giáp
arnut	quả óc chó
aroar	náo động
Arock	Một hòn đá
aroma	mùi thơm
arose	nảy sinh
arrah	sắp xếp
array	mảng
arret	cây đàn
arrow	mũi tên
arses	lừa
arson	đốt phá
artal	gia sản
artic	khớp nối
artly	nghệ thuật
artsy	nghệ thuật
arvel	mũi tên
Asare	Như là
ascan	quét
ASCAP	CÀNG SỚM CÀNG TỐT
ashed	tro tàn
Ashes	Tro
Asian	Châu Á
aside	qua một bên
async	không đồng bộ
askar	người hỏi
asked	yêu cầu
asker	người hỏi
askew	xiên
asper	theo
assay	khảo nghiệm
Asser	Khẳng định
asses	lừa
asset	tài sản
assot	đánh lừa
astay	kinh ngạc
astre	kinh ngạc
asway	đi xa
atake	làm lại
atees	người bảo vệ
ative	động cơ
ATLAS	BẢN ĐỒ
Atlee	Atletico
atoke	đóng đinh
atoll	đảo san hô
atone	chuộc lỗi
atony	mất trương lực
atour	một tour du lịch
atria	tâm nhĩ
atrip	một chuyến đi
attal	tô màu
attar	tinh dầu
Attic	Gác xép
attle	tinh dầu
attry	chứng thực
atule	sự cai trị
atune	một giai điệu
audad	thử giọng
audio	âm thanh
audit	kiểm toán
AUDIX	ÂM THANH
auger	thợ khoan
augur	chiêm tinh gia
aulas	công thức
aunty	bác gái
aunts	các dì
aurae	hào quang
aurar	hào quang
auras	hào quang
Aurel	Nguyệt quế
autos	ô tô
Autum	Mùa thu
avail	tận dụng
avens	lò nướng
avers	không thích
avert	tránh xa
avick	cuồng nhiệt
aview	một cái nhìn
avine	một cây dây leo
avoid	tránh
avoir	tránh xa
avoke	tận dụng
avour	có sẵn
avows	lời hứa
awaft	chờ đợi
aways	đi đi
await	chờ đợi
awake	thức tỉnh
awalt	khủng khiếp
awane	kinh khủng
award	phần thưởng
aware	nhận thức
awarn	đã học
awash	rửa sạch
awave	một làn sóng
aweek	một tuần
awest	kinh khủng
aweto	chờ đợi
awful	tồi tệ
awhet	đáng tiếc
awide	chờ đợi
awing	chờ đợi
awink	chớp mắt
awned	có mái che
awner	người đứng dậy
awoke	thức dậy
awols	ngu ngốc
awork	một công việc
axers	xe trục
axial	trục
axils	trục
axing	trục
axiom	tiên đề
axled	có trục
axles	trục xe
axman	người thợ rìu
axons	sợi trục
azoic	vô sinh
azure	màu xanh
baaed	la hét
Baber	em bé
baboo	điều cấm kỵ
backy	lưng chừng
Backs	Mặt sau
Bacon	Thịt ba rọi
badge	huy hiệu
badly	tệ
baffs	vách ngăn
bagel	bánh mì tròn
bagge	cái túi
baggy	rộng thùng thình
bagle	bánh mì tròn
bagre	túi xách
bayed	bay lên
bails	tiền bảo lãnh
Bains	Lợi nhuận
baits	bả
baked	nướng
Baker	thợ làm bánh
Bakes	Bánh
Bakke	Bánh nướng
baldy	hói
balds	kiện hàng
baled	đóng kiện
bales	kiện
balky	bủn rủn chân tay
balks	kiện
ballo	bong bóng
balls	những quả bóng
balmy	gàn
balms	kiện
balow	kêu la
banak	Banak
banal	tầm thường
Banda	Gấu trúc
bandy	không mui
bands	ban nhạc
baned	cấm
banes	lệnh cấm
bange	tiếng nổ
Bangs	Tóc mái
banig	lan can
Banks	Ngân hàng
banns	lệnh cấm
Banon	Cấm
barba	man rợ
barbs	ngạnh
bards	thẻ bài
bared	thanh
barff	nói xấu
barfy	thanh trừng
barfs	đầu bếp
barge	xà lan
bargh	thanh lương
barky	sủa
barks	sủa
barmy	lên men
barms	hàng rào
barns	chuồng trại
barse	thanh minh
basad	cá ba sa
basal	cơ bản
basan	cá ba sa
based	dựa trên
bases	căn cứ
BASIC	NỀN TẢNG
Basil	Húng quế
basin	lòng chảo
basis	nền tảng
baske	đánh cá
basks	bồn nước
bason	thợ nề
bassy	trầm đục
basta	khốn nạn
basto	khốn nạn
basts	bảo kê
batad	dùi cui
batch	lô hàng
batel	cây gậy
bathe	tắm rửa
baths	bồn tắm
bawdy	nói bậy
bawke	tiếng kêu
bawls	tiếng nói bậy bạ
Beach	bờ biển
beady	có hạt
beads	hạt
beaky	có mỏ
beaks	mỏ
Beall	Là tất cả
beamy	rạng rỡ
beams	dầm
beans	đậu
Beard	Râu
bears	gấu
beast	quái thú
beath	mỏ
beats	nhịp đập
beaut	mỹ miều
bebed	làm nũng
becap	beo
becut	được cắt
bedye	ngủ nướng
bedog	giường ngủ
bedub	giường ngủ
bedur	người ngủ
beech	cây sồi
beefy	lực lưỡng
beefs	thịt bò
beeps	tiếng bíp
Beers	Bia
beets	củ cải
befit	phù hợp
begad	cầu xin
begay	Là gay
began	đã bắt đầu
begat	cầu xin
beget	gây ra
Beggs	Người ăn xin
Begin	Bắt đầu
begod	là Chúa
begot	cầu xin
begum	cầu xin
begun	đã bắt đầu
begut	xin ăn
behap	cư xử
behav	cư xử
beige	be
being	hiện tại
belch	ợ hơi
belie	tin tưởng
belly	bụng
Bells	Chuông
below	phía dưới
belts	thắt lưng
belve	tin tưởng
bemad	bị điên
bench	Băng ghế
bendy	uốn cong
bends	khúc cua
Benes	Lợi ích
benty	nhiều
bents	tiền xu
Beret	Mũ nồi
bergy	giáo sĩ
berms	gờ
Berry	quả mọng
berth	bến đỗ
besan	bột đậu
besee	cầu xin
beset	bao quanh
besew	làm riêng
besit	làm riêng
besom	bỡn cợt
besot	vây quanh
bespy	làm phiền
bests	tốt nhất
betel	trầu cau
betes	cá cược
Bethe	Là
BETRS	CƯỢC
bevel	góc xiên
bevil	cái đe
bewet	say mê
bewig	mê muội
bewit	làm say mê
bewry	hoang mang
byard	tạm biệt
bibbs	cái yếm
Bybee	Tạm biệt
Bible	Kinh thánh
bicep	cái bắp tay
bices	tệ
bider	rượu táo
bidet	chậu rửa vệ sinh
bidry	đấu thầu
bifer	người chơi bifer
biffs	còng
bigas	lớn như
biggy	người lớn
bigly	to lớn
biked	đạp xe
biker	người lái xe đạp
bikes	xe đạp
bilbo	gươm
bilch	phôi thép
Bilek	Mật
bilge	lò luyện thép
bilic	song âm
bilks	phôi thép
Billi	Bida
Bills	Hóa đơn
bimbo	bim bim
binds	ràng buộc
binge	say sưa
bingo	chơi lô tô
biome	quần xã sinh vật
Biota	Hệ sinh vật
biped	hai chân
bipod	hai chân
Birch	Bạch dương
birdy	chim chóc
Birds	Chim
birks	bạch dương
Byrle	Tạm biệt
birth	Sinh
bises	bise
biset	bánh quy
bisks	bánh quy
bison	bò rừng
bitch	chó cái
bites	vết cắn
bytes	byte
bitsy	bity
byway	bằng cách
Black	Màu đen
blade	lưỡi
blame	khiển trách
blams	những lời trách móc
Bland	Dịu dàng
Blank	Trống
blare	chói lọi
blast	vụ nổ
blawn	nhuộm đỏ
blazy	rực rỡ
bleak	ảm đạm
blear	ảm đạm
bleat	kêu be be
blebs	tẩy trắng
bleck	tẩy trắng
bleed	chảy máu
bleep	tẩy trắng
blend	trộn
blenk	tẩy trắng
blens	tẩy trắng
blere	ảm đạm
bless	ban phước
blest	xanh nhất
blets	tẩy trắng
blibe	Blibe
blimy	hạnh phúc
Blimp	Khinh khí cầu
blind	mù
blini	bánh hạnh nhân
bliny	chớp mắt
blink	chớp mắt
blips	bọng nước
blirt	tán tỉnh
Bliss	Phúc lạc
blist	phồng rộp
Blitz	Chớp nhoáng
blizz	bão tuyết
bloat	sưng lên
Block	Khối
blocs	khối
bloke	nở hoa
blond	tóc vàng
Blood	Máu
Bloom	Hoa
blots	đốm màu
blowy	khô khốc
blown	thổi bay
blows	thổi
blued	xanh lam
bluff	bịp bợm
Blunt	Cùn
blurb	sự lộn xộn
blurs	làm mờ
blurt	buột miệng
blush	đỏ mặt
board	Cái bảng
boars	lợn rừng
boast	khoe khoang
boats	thuyền
boded	trùm đầu
boder	áo khoác
bodge	né tránh
bodhi	bồ đề
bodle	vẽ nguệch ngoạc
boggy	sa lầy
bogle	sa lầy
bogum	sa lầy
bogus	không có thật
boils	nhọt
boled	bắt vít
bolly	nhanh nhẹn
bolls	quả bông
bolty	táo bạo
bolts	bu lông
bombs	bom
bonds	trái phiếu
boned	có xương
bones	xương
Bonns	Tiền thưởng
bonus	Tặng kem
booby	rượu chè
boobs	bộ ngực
booed	la ó
booky	có nhiều sách
books	sách
booms	bùng nổ
boons	lợi ích
boose	con nai sừng tấm
boosy	la ó
boost	tăng
Booth	Gian hàng
booty	chiến lợi phẩm
Boots	Giày ống
Booze	Rượu
boozy	hơi say
borax	hàn the
bored	chán
Borer	Sâu đục
Bores	Lỗ khoan
borgh	cao lương
borne	chịu đựng
bossy	hách dịch
Botes	Phiếu bầu
bothy	cả hai
bottu	bottomu
bouch	quả vải
bouge	nảy lên
Bound	Ràng buộc
bourd	bầu bí
bousy	không có thật
bouts	cơn
bowed	cúi đầu
bowel	ruột
Bowes	Cung
bowly	cúi đầu
bowls	bát
boxed	đóng hộp
Boxer	Võ sĩ quyền Anh
boxes	hộp
boxty	hình hộp
bozze	rượu chè
brach	con nít
bract	lá bắc
braes	áo lót
Bragg	Khoe khoang
brags	khoe khoang
braid	bím tóc
brail	sự dũng cảm
brain	óc
brake	phanh
braky	bạo dạn
Brand	Thương hiệu
Brans	Cám
brash	hỗn láo
Brass	Thau
brast	áo ngực
brats	lũ nhóc
brave	can đảm
brawl	ẩu đả
bread	bánh mỳ
break	nghỉ
Bream	Cá tráp
breck	bẻ khóa
brede	con lai
Breed	Giống
breek	con lạch
brees	vi phạm
brens	bia
breve	lỗ thủng
brews	bia
bribe	mua chuộc
Brick	Gạch
Bride	Vị hôn thê
BRIEF	NGẮN GỌN
brigs	cầu thang
brims	vành mũ
Brine	Nước muối
Bring	Mang đến
brise	nước muối
brisk	nhanh chóng
brist	lông cứng
Broad	Rộng lớn
broch	tờ rơi quảng cáo
broil	giấy bạc
broke	phá sản
broll	nghiền ngẫm
bronc	người nuôi
brood	bố mẹ
broom	chổi
broon	cây trâm
broos	cây trâm
broth	nước dùng
browd	màu nâu
Brown	màu nâu
brows	lông mày
bruet	ngăm đen
brugh	bầm dập
bruke	bầm dập
brune	ngăm đen
brunt	ngăm đen
Brush	Chải
brusk	cái chổi
brute	vũ phu
bruzz	bầm dập
btise	lỗ mộng
bubas	bong bóng
bubby	bubbleby
Bucks	Xô
Buddh	Bạn thân
Buddy	Bạn bè
budgy	chồi non
buffs	người yêu thích
buggy	có lỗi
bugle	tiếng kêu vang
bugre	con bọ
Buyer	Người mua
build	xây dựng
built	được xây dựng
Buyse	Mua
bulbs	bóng đèn
Bulge	Phình to
bulgy	to béo
bulky	cồng kềnh
bulks	hàng loạt
Bully	Bắt nạt
bulls	bò đực
bumph	va chạm
bumpy	mấp mô
bumps	va chạm
Bunch	Bó
bundh	bó
bundt	bó
bungs	nhà gỗ
bunks	giường tầng
Bunny	Con thỏ
buoys	phao
burbs	ợ
burds	vết bỏng
burge	gờ
burgh	ợ
burgs	gùi
burys	gùi
burly	vạm vỡ
Burma	Miến Điện
Burns	Bỏng
burnt	cháy
burps	ợ hơi
burrs	gờ
burst	nổ
bused	bận rộn
buses	xe buýt
bushy	rậm rạp
busky	bận rộn
busks	người hát rong
Bussy	Âm hộ
busty	nóng nảy
busto	bức tượng bán thân
busts	bán thân
butat	Nhưng tại
butts	mông
buzzy	ồn ào
cabaa	taxiaa
Cabal	Âm mưu
cabas	xe taxi
cabby	taxi
Cable	Cáp
cabre	taxi
cache	bộ nhớ đệm
cacti	xương rồng
Cacus	Xương rồng
caddy	caddie
Cadet	Thiếu sinh quân
cadge	ăn xin
cadre	cán bộ
cafes	quán cà phê
cafoy	nhà ăn
caged	lồng
cagey	lồng lộn
cages	lồng
caggy	cheo leo
caked	đóng cục
cakey	bánh bèo
cakes	Bánh
calfs	con bê
calyx	đài hoa
calks	bê tráp
callo	chú thích
calls	cuộc gọi
calmy	bê tha
calms	bình tĩnh
calor	bình tĩnh
Calve	Bắp chân
Camel	Con lạc đà
camps	trại
Canad	Canada
canal	con kênh
Canby	Có thể bởi
Candy	Kẹo
Cando	Có thể làm được
caned	đóng hộp
canes	gậy
Canna	Dong riềng
canny	khôn ngoan
canoe	xuồng
caped	mũ lưỡi trai
caper	bạch hoa
capes	áo choàng
Capys	Mũ lưỡi trai
capot	mũ lưỡi trai
cappy	có lông
caput	mũ lưỡi trai
carap	áo khoác
carat	caravat
cards	thẻ
cared	quan tâm
Carey	Cẩn thận
carer	người chăm sóc
cares	quan tâm
caret	dấu mũ
cargo	hàng hóa
carid	khô khan
carpe	tấm thảm
carps	cá chép
Carry	Mang, thừa nhận
carrs	thợ chế tạo
carse	con ngựa
carts	xe đẩy
carve	khắc chạm
casas	áo cà sa
cased	vỏ bọc
cases	các trường hợp
casky	thùng tiền
casks	thùng
casse	thịt hầm
caste	đẳng cấp
casts	phôi
catch	chụp lấy
cater	phục vụ
CATIS	MÈO LÀ
cauld	cái vạc
causa	nhân quả
cause	nguyên nhân
cavae	ấu trùng
caval	kỵ binh
caved	hang động
caver	hang động
Caves	Hang động
cawed	có lông
cawny	có lông
CDROM	Ổ ĐĨA CD
cease	ngưng
cecal	manh tràng
cecum	manh tràng
Cedar	Tuyết tùng
ceded	nhượng lại
cedes	nhường
ceile	vỏ bọc
celeb	người nổi tiếng
Cello	Đàn Trung Hồ cầm
cells	tế bào
celom	cây celom
cents	xu
certy	xác thực
cetic	xi măng
chaft	vết nứt
Chain	Chuỗi
chair	cái ghế
chalk	phấn
chant	bài hát nhịp
chaos	sự hỗn loạn
chape	người đi kèm
chapt	đọc kinh
Chard	Cải cầu vồng
chark	than củi
charm	quyến rũ
charr	người đi làm thuê
chars	ký tự
chart	đồ thị
Chase	săn bắt
chasm	hang sâu
chats	cuộc trò chuyện
chaws	câu chuyện
cheap	rẻ
cheat	gian lận
check	kiểm tra
cheek	má
cheep	chim kêu
cheer	reo hò
chefs	các đầu bếp
chess	cờ vua
chest	ngực
chewy	dai
chews	nhai
Chick	gà con
chide	nói vui
chief	trưởng phòng
Child	Đứa trẻ
chili	ớt
Chill	Sự thư thái
chime	kêu vang
chyme	nhũ trấp
chimp	tinh tinh
China	Trung Quốc
chine	lưng heo
chins	cằm
chips	khoai tây chiên
chirk	kêu ca
chirm	tiếng kêu vang
chirp	tiếng kêu
chirr	kêu vang
chirt	kêu ca
chits	gà con
chive	Lá thơm
chivw	nói chuyện phiếm
chizz	kêu vang
choir	hợp xướng
choke	nghẹt thở
chops	chặt
chord	dây nhau
chore	việc vặt
chose	đã chọn
CHOTS	LỰA CHỌN
chunk	khúc gỗ
churl	dân quê
churm	khuấy động
churn	khuấy động
cyans	màu lục lam
cicad	con ve sầu
cycad	bánh xe xích lô
cicer	cái ve sầu
cycle	xe đạp
cyclo	xe xích lô
cidal	thủy triều
cider	rượu táo
cigar	Điếu xì gà
cigua	xì gà
cilia	lông mi
cylix	hình trụ
cymba	chũm chọe
cines	dây leo
Cynic	Hoài nghi
circs	vòng tròn
cysts	u nang
cited	trích dẫn
citee	trích dẫn
cites	trích dẫn
civet	cầy hương
civic	dân sự
civil	dân sự
civvy	công dân
Clabo	Công phu
clach	bấu víu
clack	lách cách
clads	áo khoác
claes	mệnh đề
clags	tiếng vỗ tay
claye	đất sét
claim	yêu cầu
clays	đất sét
clake	đóng cục
clamb	tiếng ồn ào
clame	nói nhảm
clamp	kẹp
clams	sò
clang	kêu vang
clank	lách cách
clans	thị tộc
clape	cái kẹp
claps	vỗ tay
clapt	vỗ tay
clart	nói chuyện phiếm
clash	sự xung đột
CLASS	LỚP
clast	nói xấu
claut	vỗ tay
clave	vỗ tay
clavy	gợn sóng
clawk	móng vuốt
claws	móng vuốt
clead	thắt lưng
clean	lau dọn
clear	thông thoáng
cleck	khóa chặt
cleek	làm sạch
clefs	khóa học
cleft	khe hở
clepe	khóa chặt
clept	nắm chặt
Clerk	Nhân viên văn phòng
clews	khóa chặt
clich	sự cắt xén
click	nhấp chuột
Cliff	Vách đá
clima	khí hậu
climb	trèo
cling	bám vào
clink	tiếng lách cách
clips	clip
clipt	cắt
cloak	áo choàng
cloam	áo choàng
clock	cái đồng hồ
clods	vón cục
cloes	đinh hương
cloff	áo choàng
clogs	guốc
cloys	áo choàng
cloit	quần áo
cloke	làm tắc nghẽn
cloky	che đậy
clomp	áo quần
clone	dòng vô tính
cloof	áo choàng
cloop	cheo leo
cloot	chiếc áo khoác
clops	tiếng vỗ tay
Close	Đóng
closh	đóng cửa
clote	áo choàng
cloth	vải
clots	cục máu đông
CLOUD	ĐÁM MÂY
clour	cặn bã
clout	quần áo
clove	Đinh hương
clown	thằng hề
cloze	đóng băng
clubs	câu lạc bộ
cluck	bộp bộp
clued	dính chặt
clues	manh mối
cluff	tiếng lách cách
clump	vón cục
clung	bám chặt
clunk	lạch cạch
coach	huấn luyện viên
coact	hiệp ước
coala	than
coaly	than
coals	than
coast	bờ biển
Coats	Áo khoác
Cobby	Sở thích
cobbs	lõi ngô
cobia	cá bớp
Cobra	Rắn hổ mang
cocci	cầu khuẩn
Cocke	Gà trống
cocky	tự phụ
Cocks	Gà trống
cocoa	ca cao
coded	mã hóa
Codel	Mã hóa
coder	lập trình viên
codes	mã số
coeds	đồng cỏ
coeff	hệ số
coffs	còng
cogue	lừa dối
cohog	con nhím
coyly	nhát gan
coils	cuộn dây
coiny	đồng xu
coins	đồng xu
coirs	người đóng giả
coked	luyện cốc
cokey	con lừa
cokes	than cốc
colds	cảm lạnh
coley	lúa mạch
colic	đau bụng
colob	màu sắc
colog	nước hoa
Colon	Đại tràng
color	màu sắc
colts	ngựa con
comby	khó khăn
combo	kết hợp
Combs	Lược
comes	đến
comet	sao chổi
comfy	thoải mái
comic	hài hước
comma	dấu phẩy
comme	khen ngợi
commy	phúng phính
commo	hỗn loạn
Comus	Hôn mê
conch	ốc xà cừ
condo	chung cư
cones	hình nón
confr	sự trao đổi
conge	cháo
consy	sự đồng ý
Const	hăng sô
CONUS	KẾT LUẬN
cooed	thủ thỉ
cooey	nói nhảm nhí
Cooks	Đầu bếp
cooly	đã bình tĩnh
cools	nguội
coons	chuột con
coops	chuồng ngựa
coopt	chuồng ngựa
coost	gà trống
cooth	răng khểnh
coots	con cu
coped	đối phó
copei	đương đầu
copes	đối phó
copra	cùi dừa
Coral	San hô
cords	dây
cored	nghiên cứu kỷ công việc
corer	cốt cán
cores	lõi
corge	cây bần
corgi	chó corgi
corke	nút chai
corky	chai sạn
corks	nút chai
corms	nút chai
Corny	Xưa
corns	bắp
cornu	ngô
corps	quân đoàn
Corse	Thô
corve	cùi bắp
cosed	chăn nuôi
costs	chi phí
cothe	có thể
couch	đi văng
coude	anh bạn
cough	ho
could	có thể
Count	Đếm
coups	đảo chính
courb	vùng ngoại ô
Court	Tòa án
couve	đi văng
coved	thèm muốn
cover	che
coves	vịnh nhỏ
covet	thèm muốn
cowed	thu mình lại
cowle	chăn bò
cowls	cao bồi
cowry	chăn bò
coxed	hợp tác
crabs	cua
crack	nứt
craft	thủ công
crags	cheo leo
cramp	chuột rút
crams	nhồi nhét
Crane	Máy trục
crany	khờ khạo
crank	tay quây
crapy	trị liệu
Crary	Danh dự
crash	tai nạn
crass	cáu kỉnh
crate	cái thùng
crave	thèm muốn
crawl	bò
crawm	thu thập thông tin
craze	sự cuồng nhiệt
crazy	khùng
creak	cót két
cream	kem
creat	người sáng tạo
creda	credita
creed	tín điều
Creek	Lạch nhỏ
creep	leo
crepe	bánh crepe
crept	len lỏi
cress	cải xoong
crest	mào
crews	phi hành đoàn
cryal	lạnh lùng
cribs	cũi
cried	khóc
cries	khóc
crime	tội ác
crimp	uốn nếp
crink	làm quăn
cripe	xếp nếp
crypt	hầm mộ
criss	vết nứt
cryst	tinh thể
croak	lạch cạch
crock	lừa đảo
crocs	giày crocs
crony	bạn thân
cronk	khúm núm
crook	kẻ gian
crops	cây trồng
Cross	Bắt chéo
crowd	bầy đàn
crowl	tiếng gáy
Crown	Vương miện
crows	quạ
croze	cắt xén
cruck	kêu răng rắc
crude	thô thiển
crudy	thô thiển
cruds	đồ vụn
cruel	hung ác
cruet	chai
crull	tàu lượn
crumb	mảnh vụn
crump	nhàu nát
crunk	mảnh vụn
cruor	tàu tuần dương
crush	người mình thích
crust	vỏ trái đất
Cuban	Cuba
cubeb	khối lập phương
cubed	hình khối
cubes	khối
cubic	hình khối
Cuddy	Bạn thân
cuffy	có lông
cuffs	còng
cuing	giám định
cuish	kháu khỉnh
culmy	khờ khạo
culms	thân cây
culot	quần cụt
culti	trồng trọt
cults	giáo phái
cumin	cây thì là
cumly	kiêm luôn
cundy	hợp thời trang
cunei	hình nêm
cunny	khờ khạo
cunts	lồn
Cupid	thần tình yêu
curby	cà ri
curbs	lề đường
curch	uốn cong
curdy	cong
curds	sữa đông
cured	chữa khỏi
curer	người chữa bệnh
cures	phương pháp chữa trị
curet	cái nạo
curfs	những đường cong
curly	quăn
curls	những lọn tóc
curns	uốn cong
Curry	Cà ri
currs	đồ cuộn
curse	nguyền rủa
curve	đường cong
curvy	cong
cushy	mềm mại
cusks	ngà voi
cutey	dễ thương
cuter	dễ thương hơn
cutie	dễ thương
cutin	cắt
cutup	cắt
Czech	Tiếng Séc
dadap	bố
dadas	bố
daddy	bố
dados	bố
daffs	hoa mắt
daggy	ngu ngốc
dayal	ban ngày
daily	hằng ngày
daint	xỉn màu
dairy	sản phẩm bơ sữa
Dalat	Đà lạt
dames	chết tiệt
damie	chết tiệt
damme	chết tiệt
damns	chết tiệt
dampy	ẩm ướt
dance	nhảy
Danic	Hoang mang
darbs	người yêu
dared	dám
darer	liều lĩnh
Dares	Liều mạng
darky	đen tối
darks	bóng tối
darns	em yêu
darst	kinh ngạc
darts	phi tiêu
dasht	gạch ngang
dassy	ngu ngốc
dated	ngày tháng
dates	ngày
daubs	đầu óc
daunt	làm nản lòng
dawed	rạng rỡ
dawny	rạng đông
dazed	choáng váng
dazes	choáng váng
deady	bế tắc
deads	người chết
deair	thầy giáo
deals	giao dịch
dealt	xử lý
deans	trưởng khoa
deare	thân yêu
Deary	Thân yêu
dearn	thân yêu
dears	nước mắt
Death	Tử vong
deave	nói chuyện phiếm
debag	mảnh vụn
debar	làm hỏng
debat	khai trừ
debel	gỡ rối
Debye	Tạm biệt
debit	ghi nợ
debts	nợ nần
debug	gỡ lỗi
debut	ra mắt
decad	suy đồi
Decay	Thối rữa
decal	đề can
decap	chặt đầu
decem	lừa dối
decke	boong
decks	bộ bài
decoy	mồi nhử
decor	thiết kế nội thất
decry	chê bai
dedal	khấu trừ
deddy	suy diễn
dedit	khấu trừ
deedy	cây cỏ
deeds	hành động
Deems	Có vẻ
deeps	vực sâu
deers	con nai
defat	chất béo
defer	hoãn lại
defet	làm hỏng
defis	khử mùi hôi
defog	khử mùi
deify	phong thần
deign	phong tước
deynt	de tổng hợp
deism	thần tượng
Deity	Thần linh
deked	chứng thư
delay	trì hoãn
delfs	bản thân
delim	phân định
Delta	Đồng bằng
delve	đào sâu
demal	ma quỷ
demit	giáng lâm
Demon	Con quỷ
Demos	Bản trình diễn
demot	trình chiếu
denim	vải denim
dense	ngu độn
denty	nhiều
dents	vết lõm
depel	kho bãi
depit	kho bãi
depot	kho chứa
depth	chiều sâu
deray	làm mất trật tự
deriv	dẫn xuất
derma	Derma
derog	con lừa
desks	bàn làm việc
dessa	món tráng miệng
DESTA	NHÀ HÀNG
Deste	Ham muốn
detar	gièm pha
detat	gièm pha
deter	ngăn cản
detox	cai nghiện
dette	gièm pha
detur	gièm pha
deuce	hạ bệ
deval	mất giá
devas	chư thiên
Dever	Sốt
devex	lỗ lõm
Devil	ác quỷ
devot	ăn tươi nuốt sống
devow	ngấu nghiến
dewax	sương mù
dewed	đọng sương
dhole	cái hố
diact	sai lầm
dials	quay số
diary	Nhật ký
diced	thái hạt lựu
dicey	xúc xắc
dicer	người đánh cá
dices	xúc xắc
dicty	độc tài
diddy	ngu ngốc
didle	cây bút lông
didnt	không
didst	đã làm
dyers	thợ nhuộm
diety	ăn ngon
diets	ăn kiêng
Dyfed	Nhuộm
dight	khó tính
digit	chữ số
digue	lừa dối
dying	sắp chết
diked	nhúng
dyked	nhuộm
dikey	con lừa
dykey	con lừa
diker	thợ đào
dyker	thợ nhuộm
dikes	đê điều
dykes	đê điều
dildo	dương vật giả
dills	thì là
dimer	ăn tối
dimit	lặn
dimly	lờ mờ
dimmy	mẹ
dynam	động
dined	ăn tối
diner	quán ăn
dines	ăn tối
dynes	thuốc nhuộm
dinge	ngu xuẩn
dingy	bẩn thỉu
dinky	buồn tẻ
dinos	khủng long
Dinse	Dày đặc
dints	lặn
diose	đánh liều
dippy	hơi điên
dipsy	động kinh
Dirck	Bẩn thỉu
direr	người chỉ đạo
direx	thảm khốc
dirgy	bẩn thỉu
dirty	bẩn thỉu
dirts	áo sơ mi
disco	sàn nhảy
discs	đĩa
dishy	làm hỏng
disks	đĩa
disli	không thích
disme	cho tôi biết
disty	xa
ditch	đào mương
ditsy	bẩn thỉu
ditty	bẩn thỉu
Ditto	Như trên
ditzy	buồn tẻ
diurn	mờ nhạt
divan	đi văng
divas	diva
dived	lặn xuống
Diver	Thợ lặn
Dives	Lặn
divet	lặn
divid	chia rẽ
divvy	chia rẽ
dizen	ngu xuẩn
dizzy	chóng mặt
doaty	chết tiệt
doats	con dòi
docks	bến tàu
doddy	ngu ngốc
Dodge	Né tránh
dodgy	tinh ranh
doers	người làm
doesn	không
dogal	giáo điều
dogey	bá chủ
doggy	Cho dại
dogly	chó đẻ
dogma	giáo điều
doily	buồn bã
doing	đang làm
doled	hình vẽ
doles	vẽ nguệch ngoạc
dolls	búp bê
dolts	chết tiệt
domal	cư trú
domed	mái vòm
domes	mái vòm
domic	độc đoán
dompt	làm sạch
donec	xongc
donee	xong việc
Donet	Xong
dongs	tiền đồng
donor	nhà tài trợ
donsy	làm biếng
donut	bánh vòng
dooms	sự diệt vong
Doone	Làm một
doors	cửa ra vào
doped	pha tạp chất
dopey	ngu xuẩn
doree	quyên góp
dormy	ngủ đông
dorms	ký túc xá
Dorry	Xe tải
Dorsy	Tồi tệ
dorts	sân bay
dosed	liều lượng
doser	người làm
doses	liều lượng
dossy	ngũ
doted	lấm tấm
dotes	chó dại
Dotty	Hơi điên
doubt	nghi ngờ
douce	lừa đảo
Douds	Đôi
dough	bột
douse	ngâm
doven	con quạ
doves	chim bồ câu
dowdy	xuống dốc
dowed	hạ xuống
dowel	chốt hạ
dower	ban cho
dowly	trầm mặc
downy	lông măng
dowry	của hồi môn
dowse	hạ thấp
dowve	đi xuống
dozed	ngủ gật
dozen	tá
dozer	máy ủi
dozes	ngủ gật
drabs	buồn tẻ
draff	phân ra
draft	bản thảo
drags	kéo
Drain	Làm khô hạn
Drake	vịt đực
drama	kịch
drank	Uống
Drape	Rem
drawk	rút ra
drawl	vẽ vời
drawn	vẽ
draws	rút thăm
dread	kinh sợ
Dream	Mơ
drear	thê lương
dreck	đống đổ nát
drees	đầm
dregs	cặn bã
dreks	cặn bã
dress	đầm
Drews	Phi hành đoàn
dryad	khô
drias	khô
dribs	nhỏ giọt
Drice	Nhỏ giọt
dried	khô
drier	khô hơn
dryer	máy sấy khô
dries	làm khô
drift	trôi dạt
drily	khô khan
dryly	khô khan
drill	máy khoan
drink	uống
drips	nhỏ giọt
dript	nhỏ giọt
dryth	khô khan
drive	lái xe
drogh	chảy nước miếng
droil	chảy nước miếng
droyl	nước dãi
droit	bay xuống
droll	rũ xuống
drone	máy bay không người lái
drool	nước dãi
droop	rũ xuống
drops	giọt
dropt	chảy nước miếng
dross	ngu ngốc
droud	lừa dối
drove	lái
drovy	chảy nước miếng
drown	chết chìm
drugs	ma túy
Drums	Trống
drunk	say
drunt	thuốc mê
drupe	thuốc mê
duals	song ca
duant	bền bỉ
duchy	công quốc
ducky	vịt con
ducks	vịt
ducts	ống dẫn
duddy	anh bạn
duded	đần độn
dudes	các anh chàng
duels	đấu tay đôi
duets	song ca
duffs	duff
dukes	công tước
dully	đần độn
dulls	xỉn màu
dumby	ngu ngốc
dumbs	ngu ngốc
dumky	ngu si
dummy	hình nộm
dumpy	đổ rác
dumps	bãi rác
dunal	tá tràng
dunch	bữa tối
dunes	cồn cát
dungy	chất xám
dungs	phân
dunny	ngu ngốc
dunno	không biết
dunts	xỉn màu
duped	lừa gạt
dupes	lừa đảo
dupla	Dupla
duple	đôi
duply	trùng lặp
dural	màng cứng
durax	màng cứng
dured	chết tiệt
duree	ép buộc
dures	chữa bệnh
Durgy	Nghi lễ
durns	chết lặng
durry	khô khan
dusks	ngà voi
Dusty	Bụi bặm
dusts	bụi
Dutch	Tiếng hà lan
duvet	chăn bông
dwarf	quỷ lùn
dwell	trú ngụ
dwelt	cư ngụ
dwine	cư trú
eably	đáng tin cậy
eager	hăng hái
Eagle	chim ưng
eared	tai
Early	Sớm
earls	bá tước
earns	kiếm được
earsh	lỗ tai
Earth	Trái đất
eased	nới lỏng
easel	giá vẽ
easer	lễ phục sinh
eases	làm dịu đi
easts	phía đông
eaten	đã ăn
eater	người ăn
eaved	được cứu sống
Eaves	Tai nghe
Ebony	Gỗ mun
ecart	sinh thái
eched	làm lu mờ
echos	tiếng vang
ecize	làm hưng phấn
ecoid	sinh thái
Ecole	Tiết kiệm
edder	người ăn cắp vặt
edema	phù nề
edged	viền
edger	người ăn thịt người
edges	các cạnh
edict	sắc lệnh
edify	gây dựng
edits	chỉnh sửa
educe	bay ra
educt	máng xối
eeler	người đánh cá
eerie	ghê rợn
effet	hiệu quả
egads	cái tôi
egall	vdall
egest	ví dụ
eggar	trứng gà
egged	có trứng
egger	người đánh trứng
Egypt	Ai cập
eyass	chướng mắt
eyers	mắt
eyess	không có mắt
eight	tám
eyght	bịt mắt
eying	sự quan sát
eyoty	mắt kính
eyrar	mỏi mắt
eyras	mắt kính
eyren	mỏi mắt
eyrer	người chứng kiến
eyres	chướng mắt
eyrie	chướng mắt
eyrir	con mắt
eject	đẩy ra
elate	phấn chấn
elbow	khuỷu tay
Elder	Đàn anh
elect	trúng tuyển
elegy	cao
eleve	nâng lên
Elevs	Elev
elfic	tráng kiện
elide	trốn tránh
Elish	Thành lập
elite	ưu tú
elogy	khoa học
elong	dài ra
elope	bỏ trốn
elops	bỏ đi
elude	lẩn tránh
elute	rửa giải
elver	yêu tinh
elves	yêu tinh
elvet	yêu tinh
EMAIL	E-MAIL
embay	bao quanh
embar	cấm vận
embed	nhúng
ember	than hồng
embog	dập nổi
embow	đưa ra
Embry	Phôi thai
embue	thêu dệt
emend	khen ngợi
emigr	người di cư
emirs	tiểu vương quốc
emits	phát ra
Emmit	Bắt chước
emote	biểu tượng cảm xúc
emove	làm mềm
empty	trống rỗng
emule	hình tượng
emuls	nhũ tương
enact	ban hành
enage	ban hành
enami	men
enapt	ban hành
enarm	ban hành
enate	tạo ra
encup	mã hóa
ended	đã kết thúc
endow	cho
endue	ban cho
eneid	thuốc xổ
enema	thuốc xổ
enemy	kẻ thù
enent	thụt lùi
enjoy	vui thích
enlay	lớp phủ
enrol	ghi danh
ensky	bảo kê
ensue	tiếp theo
entad	cầu xin
enter	đi vào
entre	cầu xin
entry	lối vào
entte	lôi kéo
envoy	sứ thần
enzym	cảm giác
epics	sử thi
epoch	kỷ nguyên
epoxy	sơn epoxy
epris	kinh ngạc
equal	công bằng
eques	bằng
equid	ngang nhau
equip	trang bị
equiv	trang bị
erade	tẩy xóa
erase	tẩy xóa
Erath	Thời đại
erect	dựng lên
erept	dựng lên
ergal	thái quá
ermit	sai sót
erode	xói mòn
erose	ăn mòn
erred	sai lầm
erron	người sai vặt
error	lỗi
erses	ngựa
erupt	phun trao
ervil	cái đe
escry	hộ tống
essay	tiểu luận
essed	tiểu luận
esses	bài luận
estab	thiết lập
estre	dục vọng
ether	ête
ethic	đạo đức
Ethyl	Etylic
ethos	đặc tính
Eucha	Thánh thể
euros	euro
evade	trốn tránh
Evant	Có liên quan
evase	trốn tránh
evene	giao thừa
event	biến cố
every	mỗi
evict	đuổi ra khỏi nhà
evils	tệ nạn
evite	trốn tránh
evoke	gợi lên
exact	chính xác
exalt	nâng cao
exams	kỳ thi
excel	vượt trội
excud	kinh ngạc
excur	tuyệt vời
execs	người điều hành
exect	loại bỏ
exert	gắng sức
exies	người yêu cũ
Exile	Đày ải
exion	sự đày đọa
exist	hiện hữu
exite	khích lệ
exits	lối ra
exode	xuất ngoại
exody	hăng hái
exopt	tháo ra
expel	trục xuất
expos	triển lãm
expwy	kinh nghiệm
exter	người tiêu diệt
extra	thêm
exude	toát ra
exult	vui mừng
exurb	ngoại ô
exust	kiệt sức
faade	ngu xuẩn
fable	truyện ngụ ngôn
faced	đối mặt
facer	người nói chuyện
faces	những khuôn mặt
facet	khía cạnh
facie	tướng mạo
facit	thuận tiện
facks	người giả mạo
facty	thực tế
facto	sự thật
facts	sự thật
faddy	lỗi mốt
faded	đã bị mờ
fader	người làm lỗi mốt
fades	tàn lụi
fadge	thời trang
fadme	lỗi mốt
fados	lỗi mốt
faffy	dở hơi
fager	cá mập
faggy	giả dối
fayed	chết tiệt
fails	thất bại
fains	sợ hãi
faint	mờ nhạt
faire	công chúa
fairy	hư cấu
fairm	công chúa
fairs	hội chợ
Faith	Sự tin tưởng
faits	lỗi lầm
faked	làm giả
fakey	giả tạo
faker	thợ làm bánh
fakes	hàng giả
Falls	Ngã
Falun	Pháp luân
famed	danh tiếng
fames	danh vọng
Fancy	Mến
fangs	răng nanh
fanit	vệ sinh
farce	trò hề
farcy	xa vời
fards	ma cà rồng
fared	đã chết
farer	người bán vé
fares	giá vé
farle	trò hề
farls	trò hề
farmy	nông trại
farms	trang trại
farse	lông xù
Farsi	Tiếng Farsi
farth	xa xôi
farts	rắm
fasts	nhịn ăn
fatal	gây tử vong
fated	định mệnh
Fates	Số phận
fatil	chất béo
fatly	mập mạp
fator	người béo
fatty	béo
faugh	giả
fault	lỗi
Fauna	Động vật
fauns	vòi nước
fause	sự dừng lại
favel	ổ chuột
favor	ủng hộ
favus	yêu thích
fawny	màu nâu vàng
fawns	xu nịnh
faxed	gửi qua fax
faxes	fax
fazed	mê muội
fears	sợ hãi
fease	chống đỡ
Feast	Tiệc
featy	lông lá
feats	kỳ công
feaze	đánh hơi
fecal	phân
feces	phân
fecit	phân
fecks	phân
feedy	chán ăn
feeds	nguồn cấp dữ liệu
feely	tin tưởng
feels	cảm thấy
feest	cuồng nhiệt
feeze	mệt mỏi
feyer	phòng tắm
feign	giả vờ
feyly	cuồng nhiệt
feist	Con chó con
felid	sai lầm
fella	anh bạn
felly	hôi hám
fells	ngã
felon	trọng tội
felts	nỉ
femes	giống cái
femic	giống cái
femur	xương đùi
fence	rào chắn
fends	chống đỡ
feods	chân chống
feoff	chống đỡ
feral	hoang dã
ferly	nhiệt thành
ferns	dương xỉ
ferry	chiếc phà
festy	uy nghiêm
fetal	bào thai
fetch	tìm về
feted	lấy
fetid	chất béo
fetor	người lấy
fetus	thai nhi
feuds	mối thù
feued	tin tưởng
feute	sợ hãi
fever	sốt
fewer	ít hơn
fezes	sốt
fezzy	sốt sình sịch
Fiber	Chất xơ
fibre	chất xơ
fibry	xơ xác
fices	tệ nạn
fiefs	thái ấp
Field	Đồng ruộng
fiery	bốc lửa
fifed	năm mươi tuổi
fifer	tốt hơn
fifes	năm mươi
fifie	năm mươi
fifth	thứ năm
fifty	năm mươi
figgy	hình tượng
fight	Đánh nhau
fiked	bị đánh
filea	tập tin
filed	nộp
Files	Các tập tin
filet	thịt thăn
fille	phi lê
filly	bẩn thỉu
fillo	điền vào
fills	lấp đầy
filmy	bẩn thỉu
films	phim
filth	rác rưởi
final	cuối cùng
finch	chim ưng
findy	khó tìm
finds	tìm thấy
fined	bị phạt
Finer	Béo hơn
fines	tiền phạt
finew	tinh
finis	kết thúc
finky	lập dị
finks	vây
finns	vây
fique	hư hỏng
firca	cây linh sam
fired	Bị sa thải
firer	lính cứu hỏa
fires	đám cháy
firms	công ty
firns	làm săn chắc
firry	chắc nịch
first	đầu tiên
fiscs	cá
fishy	tanh
Fisty	Nắm tay
fists	nắm đấm
fitly	vừa vặn
fitty	vừa vặn
fixed	đã sửa
fixer	người sửa chữa
fixes	sửa lỗi
fixit	sửa nó
fixup	sửa chữa
fizzy	có hơi
fjord	vịnh hẹp
flabs	phiến đá
flack	bong ra
flags	cờ
flail	khua khoắng
flain	phẳng lặng
flair	tư cách
flays	đốm sáng
flake	vảy
flaky	bong tróc
flame	ngọn lửa
flamy	có lông
flams	ngọn lửa
flang	mặt bích
flank	hông
flans	chảo
flaps	vạt áo
flare	bùng phát
flary	lo lắng
flash	tốc biến
flask	bình giữ nhiệt
flats	căn hộ
flawy	hoàn mỹ
flaws	sai sót
flaxy	chất lỏng
fleay	chạy trốn
fleak	chạy trốn
fleam	bọ chét
flear	bọ chét
fleas	bọ chét
flect	đánh lạc hướng
fleer	người chạy trốn
flees	chạy trốn
Fleet	Hạm đội
flegm	bọ chét
fleys	bọ chét
fleme	bọ chét
flesh	thịt
flews	đội bay
flyby	bay bằng
flick	búng tay
flics	bộ phim
flied	bay lượn
flier	phi công
flyer	tờ rơi
flies	ruồi
flimp	mềm mỏng
fling	quăng ra
Flint	Đá lửa
flipe	lật đật
flips	lật
flirt	tán tỉnh
flyte	bay
float	trôi nổi
flock	bầy đàn
floes	trôi nổi
flogs	đánh tráo
floit	phao câu
Flood	Lụt
floor	giá thấp nhất
flosh	xỉa xói
Floss	Xỉa răng
flote	làm nổi
flots	nổi
flour	bột
flout	coi thường
flowe	bay lượn
flowk	bay lượn
flown	bay
flows	chảy
flued	keo kiệt
fluey	có khói
flues	manh mối
fluff	lông tơ
fluid	dịch
fluke	sán
fluky	lanh lợi
flump	bùng phát
flung	ném
flunk	mảnh khảnh
flurn	lật tẩy
flurt	bùng lên
flush	tuôn ra
flusk	vỏ sò
flute	ống sáo
fluty	bong da
fname	biệt danh
fnese	trung quốc
foals	ngựa con
foamy	có bọt
foams	bọt
focal	đầu mối
focus	tiêu điểm
foder	thức ăn gia súc
fodge	nhà nghỉ
fogey	sương mù
Fogel	Sương mù
foggy	sương mù
fogie	chó con
fogle	sương mù
fogou	sương mù
fogus	sương mù
foyer	Trần Cao
foils	giấy bạc
Foism	Chủ nghĩa giả tưởng
foldy	gấp nếp
folds	nếp gấp
folio	lá cây
folky	dân dã
fonds	kẻ thù
fonts	phông chữ
foods	thức ăn
fools	đồ ngu
footy	chân dài
foots	chân
foray	đột phá
forby	cho bởi
forbs	ngã ba
force	lực lượng
forcy	bị bỏ rơi
fordo	làm giả
forel	nói trước
fores	trước
foret	báo trước
forex	ngoại hối
forge	làm giả
forgo	bỏ qua
Forks	Nĩa
forme	cho tôi
formy	hình thức
forms	các hình thức
forte	sở trường
forty	bốn mươi
forts	pháo đài
Forum	Diễn đàn
fossa	Fossa
fotch	vết rách
fouls	phạm lỗi
found	thành lập
fourb	bốnb
fours	bốn người
fowls	gà
foxed	bị cáo
foxer	con cáo
foxes	hai con cáo
foxie	con cáo
foxly	hồ ly tinh
frack	mảnh vải vụn
fract	gãy xương
frags	những mảnh vụn
fraid	sờn
frail	yếu đuối
frays	khung
Frame	Khung
frape	khung
fraps	khung
frary	xích mích
frass	xích mích
frate	giận dữ
fraud	gian lận
frawn	đóng khung
freak	quái đản
fream	la hét
freck	tàn nhang
Freed	Được trả tự do
freen	màu xanh lá cây
Freer	Người tự do
frees	giải phóng
freit	tự do
fresh	mới
frets	phím đàn
friar	người bảo vệ
Fried	Chiên
fryer	nồi chiên
Fries	Khoai tây chiên
frigs	tàu khu trục nhỏ
frike	tàu khu trục
frill	diềm xếp
frise	lăn tăn
frisk	chạy nhanh
friss	sự lăn tăn
frith	thứ sáu
frize	lăn tăn
frizz	lăn tăn
frock	váy yếm
froes	băng giá
frogs	ếch nhái
frond	cheo leo
frons	đóng băng
front	sự trơ trẽn
frore	băng giá
frory	vui vẻ
Frost	sương giá
froth	bọt
frowy	cau có
frowl	cau có
frown	nhăn mặt
frows	cau mày
froze	đóng băng
frugs	trái cây
fruit	Hoa quả
frump	cau có
frush	sự nghiền nát
frust	bực bội
fubby	mập mạp
fubsy	dở hơi
fucks	chị
fuder	người lải nhải
fudge	tin giờ chót
fudgy	ngu ngốc
fuels	nhiên liệu
fuffy	lông tơ
fuggy	chạy trốn
fugle	chạy trốn
fully	đầy đủ
fulls	đầy đủ
fulth	trọn vẹn
Fults	Thất bại
fumed	bốc khói
fumer	người bốc khói
fumes	khói
fumet	khói
fumid	điên cuồng
funds	quỹ
funge	Mushe
fungi	nấm
fungo	Musho
funky	sôi nổi
funks	phễu
funny	vui
furls	lông
furry	có lông
furze	lông bông
furzy	lông xù
fused	hợp nhất
fusee	cầu chì
fusel	thân máy bay
fuses	cầu chì
fussy	kiểu cách
fusty	xưa
fuzzy	mờ
Gable	đầu hồi ngôi nhà
gaffe	lỗi lầm
gaffs	những tiếng thở dài
gayal	gay
gayer	gay
Gaile	Gai
gayly	đồng tính nam
gains	lợi nhuận
gaits	dáng đi
galas	dạ hội
galey	xanh da trời
gamed	đánh bạc
gamey	trò chơi
gamer	game thủ
games	Trò chơi
gamps	linh dương
gamut	âm giai
gangs	băng đảng
gaols	ghế đẩu
gaped	há hốc mồm
gapes	trố mắt
gappy	trẻ con
garbs	quần áo
garce	mặc quần áo
garde	người làm vườn
garle	súc miệng
gases	khí
gashy	thở hổn hển
Gaspe	Thở hổn hển
gaspy	thở hổn hển
gasps	thở hổn hển
gassy	có khí
gasts	dạ dày
GATED	ĐÃ GATED
Gates	Cổng
gaucy	lòe loẹt
gaudy	xa hoa
gauds	ánh sáng
gauge	thước đo
gauls	gaul
gaumy	lòe loẹt
gaums	linh dương
gaure	dáng đi
gaurs	bò tót
Gause	Tạm dừng
gauze	gai
gauzy	gầy còm
gavel	cái búa
gawby	con bò tót
gawky	lòe loẹt
gawks	trố mắt
gawps	trố mắt nhìn
gawsy	lùn tịt
gazed	nhìn chằm chằm
gazee	nhìn chằm chằm
gazes	nhìn chằm chằm
gears	bánh răng
gecko	con tắc kè
gecks	chim mỏ quạ
geeky	ngổ ngáo
geeks	chuyên viên máy tính
geese	ngỗng trời
geest	giới tính
gelly	dạng gel
gemel	đá quý
gemmy	đá quý
gemot	đá quý
gemse	đá quý
genep	genp
genes	gien
Genie	thần đèn
genit	bộ phận sinh dục
genre	thể loại
genty	nhiều
gents	phụ nữ
genus	chi
geode	mã địa lý
gerbe	hoa đồng tiền
gerbo	chuột nhảy
germy	mầm mống
germs	vi trùng
gests	áo choàng
getas	Nhận được như
getup	đứng dậy
ghast	ghê tởm
ghole	ma cà rồng
ghoom	ma cà rồng
ghost	con ma
ghoul	Ngạ quỷ
giant	khổng lồ
gybed	tập gym
gybes	con quay hồi chuyển
giddy	ham chơi
gifts	những món quà
Gigle	Cười khúc khích
gigue	lừa gạt
giher	người cho đi
gilds	mạ vàng
gilet	áo gilet
gills	mang
gilts	nái hậu bị
gimps	con gim
ginks	đồ chơi khăm
Gypsy	Người giang hồ
gyral	con quay
girds	giùm
gyred	quay lại
gyric	con quay
girly	nữ tính
girls	các cô gái
gyron	con quay
gyros	con quay hồi chuyển
girth	đường tròn
girts	áo sơ mi
gyrus	con quay
giust	ham vui
gyved	di chuyển
givey	giàu có
Given	Được cho
giver	người cho
gives	cho
glack	lắt léo
Glady	Vui mừng
glads	vui mừng
glair	long lanh
gland	ốc lắp cáp
glans	quy đầu
glare	chói mắt
Glass	Cốc thủy tinh
glaze	Kem phủ lên bánh
glazy	tráng men
glead	lóng lánh
gleam	tia
glean	lượm lặt
glebe	lóng lánh
gleby	lóng lánh
gledy	bóng bẩy
gleed	lóng lánh
gleek	ánh sáng lấp lánh
gleen	lượm lặt
glees	ánh sáng
gleet	lượm lặt
gleit	lượm lặt
glene	lượm lặt
glens	lượm lặt
glent	lóng lánh
glial	lấp lánh
glide	lướt đi
gliff	lấp lánh
glime	lấp lánh
Glimp	Nhìn thoáng qua
glims	tia sáng
glink	lấp lánh
glint	lấp lánh
gliss	lấp lánh
gloat	hả hê
Globe	Khối cầu
globs	quả cầu
glome	ảm đạm
glood	u ám
gloom	bóng tối
Glory	Vinh quang
gloss	bóng
glost	Glost
glout	găng tay
glove	găng tay
glows	phát sáng
gloze	làm cho hả hê
glued	dán
gluey	keo
glues	keo
glump	căng cứng
gluts	trừng mắt
gnars	gặm nhấm
gnash	gặm nhấm
gnats	gặm nhấm
gnawn	gặm nhấm
gnaws	gặm nhấm
goals	bàn thắng
goaty	dê xồm
goats	dê
gobby	sở thích
godet	thần thánh
godly	tin kính
goers	người đi
Going	Đang đi
Goldy	Vàng
golds	vàng
golfs	gôn
gonef	đi
gongs	cồng chiêng
gonna	sẽ
goods	Các mặt hàng
goofy	ngốc nghếch
goofs	đồ ngu ngốc
gooky	ngu ngốc
gools	người ngu ngốc
goose	con ngỗng
gorce	phù thủy
gored	mệt mỏi
gores	máu me
gorge	hẻm núi
gorry	xin lỗi
gorsy	khó tính
gorst	ngổ ngáo
gossy	khó chịu
gotta	cần phải
gouge	đục khoét
gourd	quả bầu
gouty	bệnh gút
gowns	áo choàng
grabs	nắm lấy
Grace	duyên dáng
grade	lớp
grads	tốt nghiệp
graft	ghép
grain	ngũ cốc
grays	xám
grams	gam
Grant	Khoản trợ cấp
grape	giống nho
graph	đồ thị
grasp	sự hiểu biết
GRASS	CỎ
grate	ghim
grave	phần mộ
gravy	nước thịt
graze	ăn cỏ
Great	Tuyệt quá
grebe	màu xám
grece	màu xám
greed	tham lam
Greek	người Hy Lạp
Green	màu xanh lá
greet	chào
greys	xám
grewt	lớn lên
grice	cáu kỉnh
gride	mài mòn
grids	lưới
grief	nỗi buồn
grift	sự nghiền nát
grigs	nắm chặt
grike	nắm chặt
grill	nướng
grime	cáu bẩn
grimy	đen
grimp	nhăn nhó
grind	mài ngọc
grins	cười toe toét
grint	nghiến răng
griot	chim ưng
gripe	chuôi
griph	tiếng cười
gripy	nhăn nhó
gript	nắm chặt
grise	nhăn nhó
grith	cáu kỉnh
grits	nghiến răng
groan	than van
groat	than thở
Grobe	Áo choàng
groff	sự lộn xộn
grogs	những kẻ lộn xộn
groin	háng
grond	nhàu
groof	gâu gâu
groom	chú rể
groop	sờ soạng
groow	rên rỉ
GROPE	NHÓM
Gross	Tổng
grots	hàng hóa
grouf	gâu gâu
group	tập đoàn
grout	vữa
grovy	gàn dở
growl	gầm gừ
grown	tăng
grows	mọc
gruel	nhăn nhó
gruff	cộc cằn
gruft	càu nhàu
grume	càu nhàu
grump	càu nhàu
grunt	tiếng càu nhàu
grush	sự nghiền nát
Guana	Kỳ nhông
guano	phân chim
guard	bảo vệ
guars	đàn ghi ta
guava	trái ổi
Guelf	Bản thân
guess	
Guest	Khách mời
guffs	guff
GUIDE	HƯỚNG DẪN
guids	cá mòi
guyed	có con trai
Guild	bang hội
guilt	tội lỗi
guyot	thằng khốn
gulas	công thức
gulch	nuốt nước bọt
gulfy	nuốt nước bọt
gulfs	vịnh nhỏ
gully	khe
gulls	mòng biển
gulph	nuốt nước bọt
gulpy	nuốt nước bọt
gulps	nuốt nước bọt
Gumbo	cây mướp tây
gumly	kẹo cao su
gummy	kẹo dẻo
gundy	màu xám
gunky	có nhiều súng
gunks	súng ống
guppy	cá bảy màu
gurdy	ham chơi
gurle	mò mẫm
gursh	đầm lầy
gurts	nuốt nước bọt
gurus	guru
gushy	dày đặc
gusts	gió giật
gutsy	gan ruột
gutty	gan ruột
habit	thói quen
hacks	hack
hadal	dầu mù tạt
haded	đã làm
hadit	đã có nó
hadnt	không có
haems	có vẻ
haggy	có nhiều lông
haick	vội vàng
hayed	khô héo
hayer	cỏ khô
haiks	có lông
Haile	Lông
hails	tung hô
haire	lông lá
hairy	nhiều lông
hairs	những sợi lông
halas	bản đồ
halch	dây buộc
halfy	giảm một nửa
halke	dây buộc
hallo	ê
Halls	Hội trường
halms	dây buộc
halos	quầng sáng
halse	một nửa
halte	hate
halts	tạm dừng
halva	Kẹo hạt hướng dương
halve	giảm một nửa
Handy	Tiện dụng
Hands	Đôi tay
hange	trả thù
hangs	treo cổ
hanky	khờ khạo
hanks	cảm ơn
Hanoi	Hà nội
Happy	Vui mừng
hards	cứng
hared	được nuôi
harem	hậu cung
hares	thỏ rừng
Harms	Tác hại
harps	đàn hạc
harsh	thô ráp
hashy	băm
hasht	dấu thăng
Hasin	Có trong
hasky	băm
hasnt	chưa
hasps	dấu thăng
haste	sự vội vàng
Hasty	Nóng vội
hated	ghét
hater	người ghét
hates	ghét
haugh	mặc dù
haulm	khoai tây
hauls	hối hả
haunt	ám ảnh
haust	hừng hực
Haven	trú ẩn
haves	có
havoc	sự tàn phá
hawed	có lông
hawer	người làm thịt
hawky	diều hâu
Hawks	Diều hâu
hawse	lỗ Xích neo
hazed	mù mịt
Hazel	cây phỉ
hazes	sương mù
hazle	rắc rối
Heady	Xông lên
heads	người đứng đầu
heald	chữa lành
heals	chữa lành
heapy	chất đống
Heaps	Đống
heard	đã nghe
Hearn	Nghe
hears	nghe thấy
heart	trái tim
Heath	cây thạch thảo
heats	làm nóng
heave	phập phồng
heavy	nặng
heazy	cuồng nhiệt
hecks	quái vật
hecte	héc-ta
hedge	hàng rào
Hedie	Anh ta chết rồi
heedy	cây cỏ
heeds	cỏ dại
heels	gót giày
hefty	nặng nề
hefts	thang máy
heigh	cao
heygh	này
heild	xây dựng
heils	gai
heirs	người thừa kế
heist	trộm cắp
helas	mũ bảo hiểm
helix	vòng xoắn
helly	cầm lái
hello	xin chào
hells	địa ngục
Helot	Trực thăng
helps	giúp đỡ
hemal	huyết dụ
Heman	Anh ta là đàn ông
Hemet	Ông đã gặp
Hemon	Ma quỷ
hempy	gai dầu
hemps	cây gai
hence	kể từ đây
Henke	Rượu Henke
henna	cây lá móng
herbs	các loại thảo mộc
herds	bầy đàn
herem	đây
Herod	Hêrôđê
Heron	Diệc
heuch	thái giám
heved	chăm chú
hexad	thập lục
hexed	có dấu vết
hiant	gợi ý
hicky	nặng nề
hided	giấu giếm
hider	người đi lang thang
hides	ẩn náu
hydro	thủy điện
hield	che giấu
hyena	Linh cẩu
Higgs	Hạt Higgs
highs	mức cao
hight	Cao
hying	che giấu
hiked	đi bộ đường dài
hiker	người đi bộ đường dài
hikes	đi bộ đường dài
Hylas	Bản đồ
Hilly	Đồi núi
Hills	Những ngọn đồi
hilts	tạm dừng
Hymen	Thần hôn nhân
Hymir	Thánh ca
himne	hene
hymns	thánh ca
Hindi	Tiếng Hindi
hinds	dấu hiệu
Hindu	Người theo đạo Hindu
hinge	khớp nối
hints	gợi ý
hyped	cường điệu
hyper	siêu
hypes	cường điệu
hypha	sợi nấm
Hippo	Con hà mã
hired	thuê
hirer	người thuê
HIRES	GƯƠNG
hirse	tiếng rít
hissy	rít
hists	tổ ong
hitch	xô
hived	tổ ong
hives	tổ ong
Hoang	Hoàng
hoard	tích trữ
hoars	khản giọng
hoast	nâng cao
hobby	sở thích
hocco	khúc côn cầu
hocks	cái móc
hoddy	ham chơi
Hodge	Né tránh
hoers	cuốc đất
hoggy	heo con
Hogle	Lỗ
hoist	vận thăng
hoked	cuốc đất
Holds	Giữ
holed	tích lũy
holes	hố
holia	hoa mộc lan
holts	hậu bị
homed	cuốc đất
homey	ấm cúng
homes	những ngôi nhà
honed	mài giũa
Honey	Mật ong
honer	mài giũa
hones	mài giũa
honks	khò khò
Honor	Tôn kính
hoods	mũ trùm đầu
hoofs	móng guốc
hooky	móc ngoặc
Hooks	Móc
hoose	chó săn
hoosh	tiếng kêu
hoots	móng guốc
hoove	cuốc đất
hoped	hy vọng
Hopei	Hy vọng tôi
hopes	hy vọng
Hopin	Nhảy vào
horde	đám đông
horny	có sừng
horns	sừng
horry	kinh khủng
horse	ngựa
horsy	có ngựa
Hosea	Ôsê
hosed	cuốc đất
hoses	ống mềm
hosts	máy chủ
hotel	khách sạn
hotly	nóng bỏng
Hound	Chó săn
Hours	Giờ
House	căn nhà
houss	huyên náo
hovel	cuốc đất
hover	bay lượn
howdy	hú
howel	tiếng hú
howff	hú
howks	tiếng hú
howls	tiếng hú
Huang	Hoàng
hubby	mũm mĩm
huffs	hụ hụ
Huger	Lớn hơn
hulky	khàn khàn
hulks	đống
hulls	vỏ tàu
human	Nhân loại
humid	ẩm ướt
humor	hài hước
Humph	Hừ hừ
humpy	có bướu
humps	bướu
humus	mùn
Hunan	Hồ nam
hunch	linh cảm
Hunts	Đi săn
hurds	rào cản
Hurff	Vội vàng
hurly	nhanh chóng
hurls	ném đá
hurry	vội
Hurty	Nhanh
hurts	đau
husks	trấu
hussy	tinh ranh
hutch	cái hutch
hutre	chòi nghỉ
huzzy	hoan hô
Iache	Tôi đau
yacht	thuyền buồm
iambi	Tôi bi
yangs	Yangs
Yards	Bãi
yarns	sợi
iasis	ốc đảo
iatry	giận dữ
yawed	ngáp
yawls	ngáp
yawny	ngáp
yawns	ngáp
yawps	ngáp
icers	tảng băng
icily	xấu tính
icing	Đóng băng
Icken	Dày
ickle	ốm yếu
icons	biểu tượng
ictus	cây xương rồng
idant	làm biếng
Idden	Làm biếng
ideal	lý tưởng
ideas	ý tưởng
ident	danh tính
idest	ngu ngốc
idyll	cảnh đồng quê
idiom	cách diễn đạt
idiot	kẻ ngốc
Idism	Chủ nghĩa đồng nhất
Idist	Danh tính
idite	ngu ngốc
idled	không hoạt động
idler	người làm biếng
idles	làm biếng
idols	thần tượng
yeard	người yêu
yearn	khao khát
years	năm
yeast	men
yeech	yboards
yells	la lên
yelps	kêu la
yeply	vâng
yeses	vâng vâng
yesty	bệ hạ
yetts	chưa
yeven	men rượu
ighly	mạnh mẽ
igloo	nhà tuyết
yield	năng suất
yikes	yểu điệu
ileal	hồi tràng
ileum	hồi tràng
ileus	hồi tràng
ility	nhu nhược
Ilium	Xương hông
iller	ốm yếu
illth	bệnh hoạn
illus	ảo tưởng
Ilone	Tôi chỉ đơn thuần
image	hình ảnh
imago	tưởng tượng
imbed	im lặng
imbue	thấm nhuần
imide	im lặng
Imitt	Chuyển tiền
Imler	Im hơn
immew	bao la
immis	Immis
immit	bắt chước
immun	non nớt
impar	vô hiệu
imped	trở ngại
impel	xô
imper	không hoàn hảo
imply	bao hàm, ngụ ý
impot	bất lực
imput	sự thúc giục
inact	không hoạt động
inapt	không thích
inarm	ôm
inbye	tạm biệt
inbow	đầu vào
Incan	Inca
incle	nghiêng
incor	liêm khiết
incur	gánh chịu
incut	răng khôn
index	mục lục
India	Ấn Độ
indii	indi
indow	vào trong
indue	tới hạn
inept	say xỉn
inerm	trơ trọi
inert	trơ ra
infer	suy luận
infos	thông tin
infra	cơ sở hạ tầng
ingot	thỏi
inked	có mực
inker	máy in
inkie	mực
inkle	mực
inkos	mực
inlaw	trong vòng pháp luật
inlet	đầu vào
inned	săn chắc
Inner	Bên trong
innet	trong lưới
inone	trong một
input	đầu vào
inrub	cây bụi
inrun	đang chạy
insea	bên trong
insee	bảo lãnh
insep	thấm sâu
inset	lót trong
insol	vỡ nợ
instr	hướng dẫn
insue	lời nói dối
intel	thông tin
inter	chôn cất
intra	trong
intro	phần giới thiệu
Inuit	Người Inuit
inure	có trong tay
inust	tràn ngập
iodal	iotal
iodic	iốt
iodid	iốt
yodle	ngu ngốc
yogis	thiền sinh
yoked	say sưa
yokes	trò đùa
yolks	lòng đỏ
youff	đồ ngu
Young	Trẻ tuổi
youre	mày là
yours	của bạn
youth	thiếu niên
youve	bạn
youze	ngủ quên
Ioved	Đã xóa
Iraan	Người Iran
Iraqi	người Iraq
irate	giận dữ
irbis	báo tuyết
Irish	Người Ailen
irked	khó chịu
irony	trớ trêu
Irons	Bàn là
irous	có lửa
irred	bực bội
irreg	bất thường
Isawa	Tôi đã thấy một
Ising	Tôi hát
Islam	đạo Hồi
isled	được dẫn dắt
isles	cù lao
islet	cù lao
Islip	Tôi trượt
Ismay	Là có thể
Isman	Là người đàn ông
isoln	cô lập
issue	phát hành
isthm	eo đất
istic	gác mái
istle	hòn đảo
Italy	Nước Ý
itchy	ngứa
itcze	ngứa
itemy	lặp đi lặp lại
items	mặt hàng
ither	ngứa
ition	ý niệm
itous	có mùi
yummy	ngon
ivied	bị đuổi đi
Ivory	Ngà voi
izing	làm lạnh
jacht	du thuyền
jacks	giắc cắm
jaded	giựt giựt
jagat	răng cưa
jaggy	lởm chởm
jaggs	răng cưa
jails	nhà tù
jakes	trò đùa
jambo	tiếng ồn ào
jambs	tiếng ồn ào
jammy	kẹt cứng
janty	vui vẻ
Japan	Nhật Bản
japed	nhật bản
japes	nhật bản
jarls	biệt ngữ
jarvy	cây kim châm
jasey	vui vẻ
jaunt	đi chơi
javas	phim jav
javel	cái lao
jawab	cái hàm
jawed	có hàm
jazey	kinh ngạc
jazzy	vui vẻ
Jeans	Quần jean
Jebus	Xe Jebus
Jeeps	Xe Jeep
jeery	giễu cợt
jeers	giễu cợt
Jelks	Thạch
jelly	thạch
Jenny	cú chọc
jerky	thịt khô
jerks	giật
jests	áo gi lê
JESUS	CHÚA GIÊ-XU
jeton	máy bay phản lực
jetty	cầu cảng
Jewel	Ngọc
Jewry	Đồ trang sức
jiffy	thoáng qua
jiggy	khó chịu
jihad	thánh chiến
Jinan	Tế Nam
Jocko	Con tinh tinh
Johny	ạ
joyed	vui mừng
joins	tham gia
joint	chung
joist	chen lấn
joked	nói đùa
jokey	vui đùa
joker	người pha trò
jokes	chuyện cười
jolly	vui vẻ
jolty	vui vẻ
jolts	xóc nảy
Jorry	Xin lỗi
Joses	Hoa hồng
jotty	vui vẻ
journ	tạp chí
joust	vui đùa
jowed	giễu cợt
jowly	giễu cợt
Juana	Kỳ nhông
juans	tháng sáu
jubas	tưng bừng
jubbe	tưng bừng
jubes	vui mừng
jubus	thần thánh
Judah	Giu-đa
Judas	Giu-đa
Judge	Trọng tài
juger	người uống rượu
juice	Nước ép
juicy	ngon ngọt
juked	tung hứng
jumpy	nhảy cẫng lên
jumps	nhảy
jurel	cây nguyệt quế
juris	khu vực pháp lý
juror	bồi thẩm đoàn
justs	chỉ
jutes	đay
kayak	chèo xuồng
kayos	thuyền kayos
Kaleb	Cải xoăn
Kanji	Chữ Kanji
Karma	Nghiệp
keeps	giữ lại
keest	quan tâm nhất
keyed	có chìa khóa
keyer	người đánh chìa khóa
kempt	gấp gáp
kendo	kiếm đạo
keout	quan tâm
kerbs	lề đường
ketch	nước sốt cà chua
khaki	kaki
Khmer	Khơ me
kicky	mạnh bạo
kicks	những cú đá
kiddy	đứa trẻ
kiddo	đứa trẻ
kills	giết người
kilns	lò nung
kilos	kilôgram
kilts	kg
kinds	các loại
Kings	Các vị vua
kinky	lập dị
kinks	gấp khúc
kiosk	ki-ốt
kissy	có hôn
kites	diều
Kitty	Mèo con
kiwis	Trái kiwi
klutz	hậu đậu
knack	sở trường
knead	nhào
kneed	quỳ xuống
kneel	quỳ xuống
knees	đầu gối
knell	tiếng chuông
knelt	quỳ xuống
knezi	quỳ gối
kniaz	đan len
knife	dao
knits	đồ đan
knive	đan
knobs	nút bấm
knock	cú đánh
knoit	thắt nút
Knoll	Chuông kêu
knops	hải lý
knosp	nút thắt
knots	thắt nút
knout	thắt nút
knowe	biết
known	đã biết
knows	biết
koala	gấu túi
koans	công án
Korah	Kinh Korah
Koran	Kinh Koran
Korea	Hàn Quốc
korec	hàn quốc
Korry	K lỗi
Krein	Kerin
krill	nhuyễn thể
kudos	thanh danh
kudzu	sắn dây
Laban	la ban
label	nhãn mác
labia	môi âm hộ
labor	nhân công
laced	tẩm
lacer	người mài giũa
laces	dây buộc
lacet	rent
lache	đau nhói
lacks	thiếu
laded	đầy ắp
lader	người múc canh
lades	các chàng trai
ladle	lò nồi
Lager	Bằng lăng
lagly	trễ nải
layed	đẻ
layer	lớp
lairy	trại giam
lairs	hang ổ
laity	giáo dân
lakey	hồ nước
laker	người laker
lakes	hồ nước
lakhs	hàng vạn
Lamas	Lạt ma
lambs	cừu non
lames	lửa
lampf	lightf
lamps	đèn
LANCE	CÂY THƯƠNG
lande	hạ cánh
lands	vùng đất
lanes	làn đường
lanky	cao lêu nghêu
Lapaz	La Paz
lapel	ve áo
lapse	trôi đi
larch	cây tùng la hán
lardy	mỡ lợn
lards	mỡ lợn
large	lớn
largy	ấu trùng
larid	khô cằn
larks	chim sơn ca
larum	ấu trùng
larva	ấu trùng
larve	lớn lên
lases	mỡ
lasso	dây cột ngựa
lasty	cuối cùng
lasts	kéo dài
latch	chốt cửa
lated	ăn thịt
later	một lát sau
latex	mủ cao su
Lathe	Máy tiện
lathy	dâm đãng
latke	pha cà phê
latry	máy pha cà phê
laude	công tử
laugh	cười
laund	giặt giũ
lawed	đúng luật
Lawes	Luật
lawks	luật
lawny	bãi cỏ
lawns	bãi cỏ
Lawry	Ngành luật
lawzy	luật lệ
laxer	người lỏng lẻo
laxly	lỏng lẻo
lazed	chết mê chết mệt
lazys	lười biếng
leady	có nhiều chì
leads	dẫn đầu
leafy	lá
leafs	lá
leaky	rò rỉ
leaks	rò rỉ
leans	nghiêng người
leant	nghiêng ngả
leaps	nhảy vọt
leapt	nhảy qua
Leary	Người học
learn	học hỏi
lears	bánh răng
lease	cho thuê
leash	dây buộc
least	ít nhất
leath	nước rửa trôi
leave	rời bỏ
Leavy	Lá
leche	dâm đãng
ledge	mỏm đá
ledgy	mỏm đá
leech	con đỉa
leeky	tỏi tây
leeks	tỏi tây
leery	tinh ranh
leers	người cho vay
Lefty	Tả khuynh
lefts	đòn bẩy
legal	hợp pháp
leges	chân
leggy	chân dài
Legis	Luật pháp
legit	hợp pháp
Lello	Xin chào
lemma	bổ đề
Lemon	Chanh vàng
lemur	vong linh
lends	cho vay
Lenin	Lê-nin
lenth	thứ mười
lento	đậu lăng
leper	người cùi
lepid	cùi
lesed	bớt đi
lesiy	đồng tính nữ
letup	sự buông tha
level	mức độ
Lever	Đòn bẩy
lexic	từ vựng
lezes	le le
lezzy	lờ mờ
Liard	Nói dối
lyard	trữ vật
liars	kẻ nói dối
libel	phỉ báng
Libra	Thiên Bình
licet	chấy rận
licks	liếm
lidos	lido
lyery	trữ tình
liers	nói dối
liesh	dối trá
lieue	nói dối
lieus	dối trá
lifey	sống động
lifen	sự sống
lifts	thang máy
Light	Ánh sáng
lying	nằm
liked	đã thích
liken	ví von
liker	người nói dối
likes	thích
Lilac	Tử đinh hương
liles	nói dối
lilts	chó chết
limbi	lấp lửng
limby	tay chân
limbo	lấp lửng
limbs	chân tay
limed	vôi
limey	có màu vôi
limer	người nói dối
limes	chanh
limit	giới hạn
lymph	bạch huyết
limpy	khập khiễng
limps	khập khiễng
limsy	nhỏ xíu
linac	rượu linac
lined	lót
liney	cây nho
linen	lanh
liner	lót
lines	dòng
Linet	Vải lanh
lingy	lêu lổng
lingo	biệt ngữ
linky	liên kết
links	liên kết
Lions	Sư tử
lipid	chất béo
lyric	lời bài hát
lysis	ly giải
lisps	nói ngọng
listy	ủ rũ
lists	danh sách
liter	lít
lites	thắp sáng
lithe	vải thưa
lithi	vải thiều
lytic	trữ tình
litre	lít
litus	giấy quỳ
lived	đã sống
liver	Gan
lives	cuộc sống
livid	chảy nước miếng
livor	sự thích thú
loach	chạch
loads	tải
loafs	ổ bánh mì
loamy	mù mịt
loams	lừa đảo
loans	cho vay
loath	không ưa
loave	ổ bánh mì
lobar	cây gỗ
lobby	sảnh
lobed	thùy
lobes	thùy
lobus	xe buýt
local	địa phương
LOCAP	ĐỊA ĐIỂM
lochs	hồ
locks	ổ khóa
locum	người thay thế
locus	quỹ tích
Lodge	lều
loess	hoàng thổ
lofty	cao
lofts	gác xép
Logan	quả nhãn
loger	nhà kho
loges	lò sưởi
logic	Hợp lý
login	đăng nhập
Logos	Biểu trưng
logue	dâm ô
loyal	Trung thành
loins	thăn lưng
Lonee	Cô đơn
loner	người cô đơn
longe	khao khát
looed	lỏng lẻo
loofs	lổn nhổn
looky	có vẻ ngoài
looks	nhìn
looms	khung dệt
loony	điên khùng
loope	dây buộc
loopy	vòng vo
loory	rau lang
loose	lỏng lẻo
loots	đồ ăn cắp vặt
loped	hình tròn
loper	người yêu
lordy	chúa tể
Lords	Lãnh chúa
lored	tín ngưỡng
lores	truyền thuyết
Lorry	Xe tải
loser	kẻ thua cuộc
loses	thua cuộc
lossy	mất mát
lotah	lô tô
lotas	lô tô
lotic	gác xép
lotor	người đánh lô tô
lotos	lô tô
lotto	lô tô
Lotus	Hoa sen
louch	lười biếng
loupe	chó săn
loups	tiếng kêu to
lourd	bầu bí
loury	lười biếng
lours	tiếng kêu
louse	con rận
lousy	tồi tệ
louty	trách nhiệm
louts	nhà nghỉ
loved	yêu
lovee	người yêu
lovey	yêu kiều
Lover	Người yêu
loves	yêu
lowed	hạ thấp
Lower	Thấp hơn
Lowes	Mức thấp
lowly	hèn mọn
lowth	tầm thấp
lubes	thuốc bôi trơn
lucid	minh mẫn
Lucky	May mắn
luddy	hồng hào
ludes	dâm đãng
ludic	lố bịch
Luffa	Mướp
luged	luẩn quẩn
lulls	ru ngủ
lumpy	vón cục
lumps	vón cục
lunar	âm lịch
lunch	Bữa trưa
lunge	đột kích
lungy	lung tung
lungs	phổi
lunts	runts
Lupid	Ngu ngốc
lurch	lảo đảo
lured	bị dụ
lurer	kẻ lừa đảo
lures	mồi nhử
lurid	buồn tẻ
lurky	lém lỉnh
lurks	ẩn nấp
luser	người dùng
lusts	ham muốn
luted	tắt tiếng
luter	bên ngoài
lutes	đàn luýt
luxes	xa xỉ
luxus	xa xỉ
Mable	Có thể
Macau	Ma Cao
macaw	vẹt đuôi dài
macho	bậc nam nhi
macro	vĩ mô
madam	thưa bà
Madea	Đã làm một
madly	điên cuồng
Mafia	Xã hội đen
Mages	Pháp sư
magic	ma thuật
magma	dung nham
magot	người đánh lừa
Mayan	Người Maya
maybe	có lẽ
Maidy	Người hầu gái
maids	người giúp việc
mails	thư điện tử
mains	nguồn điện lưới
maint	bảo trì
maynt	có thể không
Mayor	Thị trưởng
mairs	người đưa thư
Maize	Bắp
majas	chuyên ngành
Major	Chính
majos	Majos
Maker	Nhà sản xuất
makes	làm cho
Malay	Tiếng Mã Lai
males	nam
malls	trung tâm thương mại
malms	nam giới
malty	ác tính
malts	mạch nha
mamba	ba
mamma	mẹ
mammy	có vú
mancy	manly
maned	có maned
maneh	bờm
Manes	Bờm
manga	truyện
Mango	Quả xoài
mania	hưng cảm
manic	phấn khích
manid	người điên
manie	người điên
manky	lưu manh
Manly	Nam tính
manor	trang viên
Maori	Tiếng Maori
Mapes	Bản đồ
maple	cây phong
MAPSS	BẢN ĐỒ
MArch	Bước đều
mares	ngựa cái
marid	khô cằn
Marks	Điểm
marry	kết hôn
marse	con ngựa
Marsh	Đầm lầy
marts	xe đẩy
MASER	MẶT NẠ
masks	mặt nạ
Mason	Thợ nề
massy	đông đúc
masts	cột buồm
match	trùng khớp
mated	giao phối
matey	vật chất
mater	trường cũ
mates	bạn tình
maths	toán học
matte	mờ
matzo	bánh mì không men
Maxim	Châm ngôn
mazed	mê muội
mazes	mê cung
meach	uốn khúc
mealy	nhiều bột
meals	bữa ăn
MEANS	CÓ NGHĨA
meant	có nghĩa là
meaty	nhiều thịt
meats	các loại thịt
meaul	ma cà rồng
Mecca	Thánh địa
medal	huy chương
Media	Phương tiện truyền thông
medle	xen kẽ
Meece	Nhu mì
Meeks	Gặp gỡ
meets	gặp gỡ
melds	hợp chất
melee	cận chiến
Meles	Tan chảy
melic	giai điệu
mells	những người bạn
melon	dưa gang
melts	tan ra
Memel	Màng
memos	ghi nhớ
mends	sửa chữa
menow	tôi lúc này
menus	thực đơn
meows	meo
merch	hàng hóa
Mercy	Nhân từ
merel	chỉ
merer	chỉ
meres	chỉ
merge	hợp nhất
mergh	vui vẻ
merit	n: Xứng đáng
merls	vui vẻ
Merry	vui
meshy	mê hồn
mesic	mê hoặc
messy	lộn xộn
metal	kim loại
meted	đã gặp
meter	Mét
metho	thuốc mê
meths	thần thoại
metic	làm tỉ mỉ
metre	Mét
metro	tàu điện
metze	mê man
mewed	kêu meo meo
mezzo	Meo
Micro	Vi mô
middy	giữa chừng
midgy	trung bình
midst	ở giữa
miffs	sương mù
might	có thể
miked	có mùi
milch	gia súc cho sữa
Miles	Dặm
milia	mụn thịt
milit	dân quân
milky	màu trắng đục
Milks	Vắt sữa
milpa	nương rẫy
mimed	nghiền ngẫm
mimer	cối xay
mimic	bắt chước
minds	tâm trí
mined	khai thác
Miner	Thợ mỏ
Mines	Mỏ
minge	hòa nhập
mingy	trộn lẫn
minim	tối thiểu
minks	chồn
Minor	Người vị thành niên
minty	bạc hà
mints	bạc hà
minus	dấu trừ
Mirac	Kỳ diệu
mired	sa lầy
mires	bãi lầy
mirky	không có gương
mirks	gương
mirly	gương
mirvs	gương
misce	khốn nạn
misdo	làm sai
miser	keo kiệt
mises	tiếng ồn ào
misgo	sai lầm
mysid	thần bí
Mysis	Chị gái của tôi
misky	lầm lì
misly	lầm lạc
Misty	Có sương mù
miter	lỗ đít
mites	con ve
myths	thần thoại
mitty	găng tay
mitts	găng tay
mixed	Trộn
mixen	trộn
mixer	máy trộn
mixes	hỗn hợp
mixup	trộn lẫn
mizzy	mờ ảo
mnage	sự tàn sát
moans	tiếng rên rỉ
moats	hào
mocks	chế giễu
modal	phương thức
model	người mẫu
moder	hiện đại
modes	các chế độ
moire	động cơ
Moism	Động lực
moist	ẩm ướt
moity	thần thái
molar	răng hàm mặt
moldy	bị mốc
molds	khuôn đúc
moles	nốt ruồi
molts	lột xác
momma	mẹ
momme	mẹ
Mommy	Mẹ ơi
monad	đơn nguyên
mondo	kiếm đạo
money	tiền bạc
monks	Các nhà sư
month	tháng
Monts	Khoảnh khắc
mooch	đi lang thang
Moody	buồn rầu
moods	tâm trạng
mooed	kêu la
mools	người ngu
moons	mặt trăng
moorn	sự chế nhạo
moors	đồng hoang
moose	con nai sừng tấm
moped	người đi xe máy
moper	người lau nhà
mopes	khăn lau
mopus	cây lau nhà
moral	có đạo đức
Morar	Tinh thần
Morea	Nhiều hơn
mores	nhiều hơn nữa
moric	tinh thần
moron	ngu ngốc
moror	kinh dị
Morry	Xin lỗi
mosks	người Hồi giáo
mossy	có rêu
mosso	rêu
moste	nhất
mosts	hầu hết
motey	vi trần
motel	nhà trọ
moths	bướm đêm
motif	mô típ
motor	động cơ
motto	châm ngôn
mould	khuôn
moult	thay lông
Mound	Gò đất
Mount	Gắn kết
mourn	thương tiếc
MOUSE	CON CHUỘT
mouth	mồm
moved	di chuyển
mover	người vận động
moves	di chuyển
movie	bộ phim
mowch	máy cắt cỏ
mowed	cắt cỏ
mower	máy cắt cỏ
mowse	cái giẻ lau
mowth	bướm đêm
Mozes	Chuyển động
MPers	Nghị sĩ
mucic	chất nhầy
mucky	may mắn
mucus	chất nhầy
mudar	bùn đất
mudde	bùn đất
muddy	bùn lầy
mudee	bùn
mudir	bùn đất
mudra	bùnra
muffs	bịt miệng
mufty	ngu ngốc
muggy	nóng ẩm
mulch	lớp phủ
muled	bỏ rơi
mules	con la
multi	đa
mummy	xác ướp
mumms	các bà mẹ
mumsy	mẹ già
mumus	mẹ
Muong	Mường
mural	tranh tường
mured	nấu chín
murga	Murga
murid	khô khan
murky	âm u
murks	giết người
murly	âm u
murph	âm u
murra	Murra
murrs	những kẻ giết người
murva	Murva
murza	Murza
musal	nhựa đường
mused	trầm ngâm
muser	trầm ngâm
muset	súng hỏa mai
mushy	ủy mị
music	Âm nhạc
musit	trầm ngâm
musky	xạ hương
musks	xạ hương
mussy	ủy mị
musth	trầm ngâm
musty	meo
musts	phải
mutch	người khốn nạn
muted	tắt tiếng
mutes	tắt tiếng
mutic	đột biến
muton	thịt cừu
mutts	những lời dị nghị
muzzy	khờ khạo
nacre	xà cừ
naggy	cằn nhằn
naght	ngủ nướng
nagor	nũng nịu
naily	nũng nịu
nails	móng tay
naive	ngây thơ
naked	khỏa thân
named	được đặt tên
namer	người đặt tên
Names	Tên
Nanny	Bảo mẫu
napal	bom napal
napes	gáy
Nappy	Tã lót
narco	ma tuý
narky	trầm tĩnh
narks	câu chuyện
nasal	mũi
nasat	mũi
nasch	mũi tên
nasty	bẩn thỉu
nates	thiên nhiên
nauch	nũng nịu
Naval	Hải quân
navel	lỗ rốn
navig	điều hướng
nawle	nũng nịu
Nazis	Đức quốc xã
nears	gần
neats	nịt
necks	cổ
necro	hoại tử
needy	túng thiếu
needn	thiếu thốn
needs	nhu cầu
Negro	Da đen
neigh	tiếng hí
Nepal	Nêpan
nerdy	mọt sách
nerds	mọt sách
nerts	áo sơ mi
nerve	thần kinh
nervy	lo lắng
nesty	kín đáo
nests	tổ
neuks	thần kinh
never	không bao giờ
newer	mới hơn
newly	mới
newsy	ít tin tức
newts	sa giông
nexus	mối quan hệ
ngaio	ngai vàng
nibby	nhỏ nhen
nicer	tốt hơn
niche	thích hợp
nided	có tuổi
nides	các cháu gái
niece	cháu gái
nific	hư cấu
nifty	tiện lợi
nighs	tối
night	đêm
nines	số chín
ninja	nhẫn giả
ninny	ngu ngốc
ninth	thứ chín
Ninus	Nhân viên hỗ trợ
ninut	hạt dẻ
nippy	lanh lợi
Noble	Cao quý
nobly	cao quý
nobut	không nhưng
nocks	lỗ đít
nodal	nốt sần
noddi	gật đầu
noddy	gật đầu
noded	được đánh giá
nodes	điểm giao
nodus	nốt sần
noels	noel
Nogas	Không có ga
nohes	mũi
nohow	dù thế nào đi nữa
noily	ồn ào
noise	tiếng ồn
noisy	ồn ào
Nolie	Không nói dối
nomad	người du mục
Nonie	Không Nie
nooky	ngông cuồng
nooks	ngóc ngách
noons	buổi trưa
noose	thòng lọng
norms	định mức
North	Bắc
nosed	mũi
nosey	tò mò
noses	mũi
notal	dấu ấn
notan	không phải là một
notch	khía
noted	lưu ý
noter	người ghi chép
notes	ghi chú
NOTIS	KHÔNG LÀ
Notts	Ký hiệu
Notus	Không phải chúng tôi
nould	không nên
nouns	danh từ
novae	no ấu trùng
novel	cuốn tiểu thuyết
Novum	Tháng mười một
noway	không đời nào
nowch	bây giờ
nowed	bây giờ
nowts	bây giờ
nubby	mũm mĩm
nuddy	bạn thân
nudes	khỏa thân
nudge	huých
nukes	vũ khí hạt nhân
numbs	tê liệt
numps	xà nu
numud	tê dại
nunce	ni cô
Nunci	Sứ thần
nunks	ni cô
nunni	ni cô
nunry	nữ tu sĩ
Nurse	Y tá
nursy	bảo mẫu
nutsy	dở hơi
nutty	bổ dưỡng
oakum	xơ gai
oases	ốc đảo
oasis	ốc đảo
oasts	mái chèo
oaten	yến mạch
oaths	lời thề
oaves	mái hiên
obeah	vâng
Obeid	Vâng lời
obeys	vâng lời
obese	Béo phì
obits	vâng lời
objet	phản đối
obmit	vâng lời
occas	thỉnh thoảng
occur	xảy ra
ocean	đại dương
ocher	đất son
ochre	đất son
octad	quãng tám
octal	bát phân
octet	bát phân
oddly	kỳ quặc
odist	người mùi mẫn
odium	chê bai
odors	mùi hôi
odour	mùi
oelet	bộ xương
ofays	của ngày
offal	nội tạng
offer	chào hàng
offic	chính thức
often	thường
ogams	yêu tinh
ogive	cầu hôn
ogler	yêu tinh
ogles	yêu tinh
ogres	yêu tinh
ohmic	có tính thuần trở
oiled	bôi dầu
oiler	người đổ dầu
okays	được rồi
olden	già đi
Older	Lớn hơn
oldie	người già
olepy	cây mềm
oleum	lưu toan
Olive	Ôliu
ollas	ô dù
ology	khoa học
Omani	Oman
omens	điềm báo
omits	bỏ sót
oncet	một lần
Onego	Một lần đi
Onemo	Một khoảnh khắc
onion	hành tây
onlap	trong lòng
onset	sự khởi đầu
oohed	rỉ ra
oozed	rỉ ra
oozes	rỉ ra
opens	mở ra
opine	thuốc phiện
oping	chọn
opium	thuốc phiện
opted	đã chọn
optic	quang học
orach	trái đất
orale	trái đất
orals	miệng
orary	hành trình
orate	ca tụng
orbed	giường ngủ
orbit	quỹ đạo
Orcas	Cá voi sát thủ
order	đơn hàng
ordos	đơn hàng
oread	sơn tinh
orgal	pháp luật
organ	đàn organ
Orgas	Cực khoái
orgue	hành giả
Orion	hành
orkey	ổ khóa
orles	quả cầu
orlet	hòn non bộ
Orpha	Mồ côi
orris	đăng ten
orrow	ném đá
orvet	vật nuôi dưỡng
osmic	thẩm thấu
Ossip	Chuyện phiếm
Ostic	Thẩm thấu
otary	con rái cá
otate	rái cá
Other	Khác
Otter	Rái cá
ought	phải
Ouija	cầu cơ
ousts	lật đổ
outby	ra ngoài bởi
outdo	làm giỏi hơn
outed	đi chơi
Outer	Bên ngoài
outgo	đi ra ngoài
outly	bề ngoài
outre	ra ngoài
ouvre	yêu tinh
ovals	hình bầu dục
ovary	buồng trứng
ovens	lò nướng
overs	vượt qua
overt	công khai
ovine	noãn
ovism	rụng trứng
ovist	trứng cá
ovoid	hình trứng
ovule	phôi châu
Owain	Sở hữu
Owens	ông chủ
owght	đúng
owing	mắc nợ
owler	con cú
owlet	con cú
owned	sở hữu
owner	chủ nhân
owser	chủ nợ
oxfly	chuồn chuồn
oxide	ôxít
oxids	oxit
ozone	khí quyển
paauw	móng chân
paced	nhịp độ
paces	bước
Pacht	Du thuyền
packs	gói
pacts	hiệp ước
Paddy	Thóc
pagan	người ngoại đạo
paged	phân trang
pager	máy nhắn tin
Pages	Các trang
pagne	trang
pagod	trang
pagus	ngoại đạo
payed	trả tiền
payee	người nhận tiền
payer	người trả tiền
paiks	ghép đôi
pails	thùng
pains	đau đớn
paint	Sơn
payor	người trả tiền
pairs	cặp
pairt	ghép đôi
paise	tấm lát
palch	bàn tay
paled	tái mặt
Paley	Xanh xao
paler	nhạt màu
palet	bảng màu
palmy	xanh xao
palms	lòng bàn tay
palps	bàn tay
palsy	bại liệt
panda	gấu trúc
paned	lát đá
panel	bảng điều khiển
panes	ngăn
pangs	đau đớn
Panic	Hoảng loạn
panty	quần lót
panto	tủ đựng quần áo
pants	quần dài
papal	giáo hoàng
papas	giấy papas
paper	giấy
papyr	giấy cói
pappy	nhõng nhẽo
paras	cây dù
parch	phơi
parde	sự tha thứ
pardy	ân xá
pared	ngang ngửa
parel	quần áo
paren	dấu ngoặc
Parks	Công viên
parle	miếng vải
parly	ngang hàng
parse	phân tích cú pháp
parti	chia tay
party	buổi tiệc
parts	các bộ phận
pases	bình hoa
pasta	mỳ ống
paste	dán
pasty	nhão
pasts	quá khứ
patch	vá
Pater	Cha
pathy	đường mòn
paths	những con đường
patia	hiên nhà
patio	sân trong
patly	nhẹ nhàng
patte	vỗ nhẹ
pause	tạm ngừng
pavan	gian hàng
paved	lát đá
Paver	Thợ lát đá
paves	lát nền
pavis	gian hàng
pawaw	cái cưa
pawed	vót
pawer	người cầm đồ
pawky	vồ vập
pawls	vọc
pawns	con tốt
Peace	Hòa bình
peach	quả đào
peage	cao điểm
peags	hạt đậu
peaky	hơi xanh
peaks	đỉnh cao
peans	hạt đậu
Pearl	Ngọc trai
Pears	Lê
peaty	than bùn
peats	than bùn
peavy	hạt đậu
pecan	quả hồ đào
pecks	mổ
pedal	bàn đạp
pedee	người bán dạo
Peder	Người đi bộ
pedes	bàn đạp
peeke	nhìn trộm
peeks	nhìn trộm
peels	vỏ
peeps	nhìn trộm
Peers	Ngang hàng
peles	pê đê
pelts	viên
penal	hình phạt
pendn	mặt dây chuyền
pends	chờ đợi
penis	dương vật
Penny	Đồng xu
pensy	tiền bạc
penup	bồi thường
Peony	Hoa mẫu đơn
perch	cá rô
perdy	vui đùa
peril	hiểm họa
perky	vui tươi
Perks	Đặc quyền
Perse	Mỗi gia nhập
pesky	phiền hà
pesos	peso
pesto	sốt lá húng
pests	sâu bọ
petal	cánh hoa
petro	Petro
Petty	Nhỏ nhắn
pewit	chim te te
phase	giai đoạn
phies	lừa đảo
phyll	cây cỏ
phyte	thực vật
phone	điện thoại
phony	rởm
photo	hình chụp
phots	phot
piano	đàn piano
pical	buồn cười
picky	kén chọn, khó tính
picks	hái
picry	dã ngoại
piece	mảnh
piety	lòng mộ đạo
Piggy	Heo con
pigly	heo con
piked	chọc ngoáy
piker	người đi đường
pilaf	cơm thập cẩm
pilau	đồ gia vị
pilaw	cơm chiên
pilch	ăn cắp vặt
piled	chất đống
pilei	cọc
piler	người ăn cắp vặt
piles	cọc
pills	thuốc
pilmy	có lông
pylon	cột điện
pilot	Phi công
pilus	tiêm mao
pimps	ma cô
pinch	nhón
pindy	hợp thời trang
piney	cây tùng
piner	cây tùng
Pines	Cây thông
pings	ping
pinky	hồng hào
pinko	màu hồng
pinks	màu hồng
Pinna	Bính âm
Pinon	Pin trên
pints	panh
pinup	bìm bịp
pions	chim bồ câu
pious	ngoan đạo
pipal	pipet
piped	đường ống
pipey	có mùi hôi thối
pipes	đường ống
pipit	pipet
pyres	giàn thiêu
pyric	môn vị
pirog	chim câu
pisky	nhõng nhẽo
piste	đường piste
pitch	sân bóng đá
piths	đường ống
Pitys	Tội nghiệp
pivot	trục
place	địa điểm
plack	sự cố gắng
plage	nhổ lông
plaid	kẻ sọc
plain	đơn giản
plays	vở kịch
plait	tết bện
plane	chiếc máy bay
Plank	Tấm ván
plans	các kế hoạch
plant	thực vật
plash	ao
Plate	Đĩa ăn
platy	thú mỏ vịt
plats	cái đĩa
plaud	plud
plaza	quảng trường
plead	biện hộ
Pleas	Những lời cầu xin
pleat	nếp gấp
plebe	cầu xin
plebs	cầu xin
pleck	cầu xin
pleis	sự cầu xin
plena	lời cầu xin
pleny	cầu xin
pleon	cầu xin
plews	nài nỉ
plied	xếp nếp
plier	cái kìm
plock	khóa
plods	vỏ bọc
ploid	lưỡng bội
plops	làm ơn
plots	âm mưu
plott	bàn vẽ
plows	máy cày
pluck	nhổ lông
pluff	chất dẻo
plugs	phích cắm
plumb	dây dọi
Plume	Lông chim
plumy	màu mận chín
plump	đầy đặn
plums	mận
plush	sang trọng
Pluto	Sao Diêm Vương
pneum	khí nén
poach	săn trộm
pobby	tồi tàn
POBox	Hộp thư
pocky	có gai
pocks	lỗ chân lông
pocul	đăm đăm
pocus	làm nũng
poems	những bài thơ
poesy	bảnh bao
poets	nhà thơ
pogey	vênh váo
poind	làm nũng
Point	Điểm
poise	đĩnh đạc
poked	chọc
poker	xì phé
pokes	chọc
polar	cực
poles	cột điện
polio	bệnh bại liệt
polka	chấm bi
polls	cuộc thăm dò ý kiến
pommy	bã đậu
pomps	chó săn
pondy	trầm tư
ponds	ao
poods	pood
poofy	làm khô
poofs	lông xù
pools	hồ bơi
Poore	Nghèo
poove	cái nghèo
popes	giáo hoàng
poppa	cha
Poppy	Cây thuốc phiện
porch	hiên nhà
pored	miệt mài
porer	người đăm chiêu
pores	lỗ chân lông
poret	chim bìm bịp
porky	như heo
porny	dâm đãng
porno	khiêu dâm
ports	cổng
posed	đặt ra
posey	dáng điệu
poser	người đặt
poses	tư thế
posse	quyền sở hữu
possy	sở hữu
posts	bài viết
potch	cái bô
poter	chăm sóc
potsy	có mùi thơm
potty	bô
pouce	túi đựng
pouch	túi đựng
poucy	túi nhỏ
pouff	cái túi
poufs	túi đựng
poule	túi nhỏ
poulp	chó săn
poult	đổ ra
Pound	Pao
pours	đổ
pousy	có mùi hôi
pouty	bĩu môi
pouts	bĩu môi
POWER	SỨC MẠNH
powny	cường tráng
poxed	bị thương
praya	cầu nguyện
prays	cầu nguyện
prand	cầu nguyện
prank	chơi khăm
prase	bài đọc
prawn	tôm
predy	vui đùa
preed	làm trước
preen	rỉa lông
prees	con mồi
preys	con mồi
prepd	chuẩn bị
prepg	chuẩn bị trước
prepn	chuẩn bị
Press	họp báo
prest	cá tính
preve	làm trước
Price	Giá bán
prich	chích chòe
pricy	quý giá
prick	đâm
Pride	Tự hào
pridy	con trai
pried	cạy
prier	mồi
pryer	cạy phá
prime	xuất sắc
primp	gai góc
prims	mồi
prink	châm chọc
print	in
Prior	Trước
prise	phần thưởng
privy	riêng
prize	phần thưởng
probe	thăm dò
prodd	thần đồng
prods	thần đồng
progs	cầu cứu
promo	quảng cáo
prone	dễ bị
prong	đâm
proof	bằng chứng
propr	người ủng hộ
props	đạo cụ
prose	văn xuôi
prosy	thuận lợi
prost	lạy
Proud	Hãnh diện
prove	chứng tỏ
prowl	rình mò
proxy	Ủy quyền
prune	tỉa cành
prunt	cắt tỉa
psalm	thánh vịnh
pseud	giả danh
pubal	xương mu
pubes	quán rượu
pubic	mu
pudda	vũng nước
puddy	bạn thân
pudge	Pudge
pudgy	béo lùn
puffy	sưng húp
puffs	bánh xốp
puget	làm phiền
puked	nôn mửa
puker	người ăn vạ
pukes	chó đẻ
puled	đập
pulls	kéo
pulpy	bột giấy
pulps	bột giấy
pulse	xung
pumps	máy bơm
Punch	Cú đấm
punct	chấm câu
pungy	hăng
punky	lùn tịt
punny	ngu xuẩn
punty	còi cọc
punts	trò đùa
pupae	nhộng
pupal	con nhộng
pupas	con nhộng
pupil	học sinh
Pupin	Học sinh
puppy	cún yêu
pured	chăm sóc
puree	xay nhuyễn
purey	tinh khiết
purer	tinh khiết hơn
purge	thanh trừng
purls	kim tuyến
purry	rỉ rả
purrs	tiếng gừ gừ
Purse	Cái ví
pursy	hầu bao
purty	nước bọt
puses	xe buýt
pushy	tự đề cao
Pussy	Âm hộ
putid	ngu ngốc
puton	đưa vào
putty	bột bả
putto	đặt vào
quack	lang băm
quaff	cút
Quail	chim cun cút
quays	câu chuyện
quake	động đất
quaky	run rẩy
qualm	chất lượng
Quant	Số lượng
quash	hủy án
Queen	nữ hoàng
queer	người kỳ lạ
quegh	kêu đau
queys	xếp hàng
quell	dập tắt
quelt	yên lặng
query	truy vấn
quest	nhiệm vụ
queue	xếp hàng
Quick	Nhanh
quiet	Yên tĩnh
Quill	lông nhím
quilt	may chăn
quips	châm biếm
quirt	roi da
quite	khá
quits	bỏ cuộc
quods	quod
quoin	chêm
quota	hạn ngạch
quote	Trích dẫn
Quran	Kinh Qur'an
raash	cơn thịnh nộ
Rabbi	Giáo sĩ
rabic	dại dột
rabid	dại dột
raced	chạy đua
racer	tay đua
races	các cuộc đua
racks	giá đỡ
radii	bán kính
RADIO	ĐÀI
radix	cơ số
radly	triệt để
raffe	cà phê
raffs	raff
rafty	thô lỗ
rafts	bè
raged	nổi cơn thịnh nộ
ragee	cơn thịnh nộ
rages	cơn thịnh nộ
raggy	rách rưới
ragis	nho khô
Rahab	Ra-háp
raids	đột kích
rayed	tia sáng
rails	đường ray
rainy	nhiều mưa
Rains	Mưa
raise	nâng lên
raked	cào
rakee	cái cào
raker	người cào
rakes	cào
rakis	nho khô
rally	tập hợp
Ramah	Ra-ma
ramed	hoành hành
ramie	gai
ramps	đường dốc
ranch	trang trại chăn nuôi
rands	mưa gió
Range	Phạm vi
ranks	cấp bậc
ranny	chảy nước miếng
raped	bị hãm hiếp
rapes	hãm hiếp
rapid	nhanh
rared	rạo rực
rarer	hiếm hơn
rares	Hiếm
rased	hoành hành
raser	người ăn cắp
rases	các cuộc tấn công
raspy	rôm rả
rasps	nói rôm rả
rasty	hấp tấp
ratch	vết rách
rated	đánh giá
rater	lên lương
rates	giá
Ratib	Tỷ lệ
ratio	tỉ lệ
ratty	chuột cống
raved	say sưa
raves	mê sảng
rawer	người thô sơ
rawly	thô sơ
raxed	bực bội
razed	san bằng
razes	cơn bão
razor	dao cạo
reach	chạm tới
react	phản ứng
readd	thêm lại
Reade	Phản ứng
Ready	Sẵn sàng
reads	đọc
realm	cảnh giới
reals	thực
reams	doa
reaps	gặt hái
rearm	trang bị lại
rears	hậu phương
reasy	hợp lý
reask	ráp lại
reast	nấu lại
Reave	Phản ứng
rebab	phản đòn
rebag	phản pháo
rebar	thép cây
rebbe	phản đối
rebed	lau sậy
Rebel	Nổi loạn
rebid	trả giá lại
rebop	bật lại
rebox	hộp lại
rebud	phản đối
rebuy	mua lại
rebus	xe buýt
rebut	phản bác lại
recap	tóm tắt lại
recce	rút lại
recip	người nhận
Recit	Đọc thuộc lòng
recpt	đọc lại
recta	trực tràng
recur	tái diễn
recut	rút lại
reded	đỏ
redes	thiết kế lại
redid	màu đỏ
redye	mắt đỏ
redip	làm lại
redly	có màu đỏ
redos	làm lại
redox	oxy hóa khử
redry	làm lại
redue	màu đỏ
Reeds	Lau sậy
reefs	đá ngầm
reeky	nhu mì
reeks	tuần
reels	cuộn
refel	đổ xăng
refer	tham khảo
refit	trang bị lại
refix	sửa lại
refry	nấu lại
regal	Quốc vương
regel	hối hận
REGIS	ĐĂNG KÝ
regle	hối hận
rehab	trại cai nghiện
reify	cụ thể hóa
reign	trị vì
reink	nối lại
reins	dây cương
Reiss	Phát hành lại
reist	tồn tại
rekey	khóa lại
Relay	Chuyển tiếp
relap	tái phát
relax	thư giãn
relic	Thánh tích
relig	tôn giáo
relit	thích thú
Relly	Thật chứ
remap	sửa lại
remen	nhớ lại
Remer	Nhắc nhở
remet	nhớ lại
remex	nhớ lại
remit	nhiệm vụ được giao
remix	phối lại
remop	làm lại
remue	còn sót lại
renal	thận
reneg	gia hạn
renew	thay mới
renky	cáu kỉnh
rente	người cho thuê
rents	tiền thuê nhà
reoil	reo hò
reown	phục hồi
repad	đắp lại
repay	trả lại
repeg	lặp lại
repel	đẩy lùi
repew	lặp lại
reply	Đáp lại
repot	thay chậu
repry	trồng lại
Repub	Đăng lại
rerow	mọc lại
rerub	lau lại
rerun	chạy lại
resay	nói lại
resaw	thay đổi hình dáng
Resee	Gửi lại
reset	cài lại
resew	làm lại
resex	gửi lại
resid	cư xá
resin	nhựa thông
resit	sửa lại
resod	sửa lại
Resor	Người bán lại
resow	cho lại
Reste	Nghỉ ngơi
resty	bồn chồn
restr	người phục vụ
rests	nghỉ ngơi
resue	nghỉ việc
resun	nối lại
resup	sửa lại
retag	đánh dấu lại
retal	nói lại
retar	nói lại
retch	sửa lại
rethe	thử lại
retia	võng mạc
retie	về hưu
retry	thử lại
retro	cổ điển
Reuel	Tiếp nhiên liệu
reune	đoàn tụ
reuse	tái sử dụng
revay	quay lại
revel	vui chơi
rever	hồi âm
revet	kè
revie	hồi sinh
revue	sửa lại
rewax	sáp ong
rewed	làm lại
rfree	miễn phí
rheas	hùng biện
rheen	tu từ
rheic	hùng biện
rhema	hùng biện
rheme	hùng biện
rhyme	vần
rhymy	có vần điệu
rhino	tê giác
rhyta	vần điệu
rhoea	hoa đỗ quyên
rhomb	hình thoi
ribat	sườn
ribby	tồi tàn
Ribes	Gân
ricey	gạo tẻ
ricer	tay đua
rices	cuộc đua
richt	giàu có
rides	cưỡi ngựa
ridge	cây rơm
ridgy	khó hiểu
rifer	người chạy đua
rifle	súng trường
rifty	ngang ngược
rifts	rạn nứt
right	bên phải
rigid	cứng rắn
rigol	giàn lạnh
rigor	sự nghiêm khắc
riled	gợn sóng
rinds	vỏ
ringy	chuông
rings	Nhẫn
rinks	sân trượt
rinse	rửa sạch
riots	cuộc bạo động
riped	xé toạc
ripen	chín
ripes	dây thừng
ripup	xé ra
risen	trỗi dậy
riser	ống đứng
rises	mọc
risky	rủi ro
risks	rủi ro
rites	nghi thức
ritzy	sang trọng
rival	đối thủ
River	dòng sông
rivet	đinh tán
roads	những con đường
roams	đi lang thang
roans	tiếng kêu la
roars	tiếng gầm rú
roast	thịt nướng
robed	áo choàng
robes	áo choàng
roble	lăn lộn
robot	người máy
rocks	đá
Roger	Nghe rõ
rogue	giả mạo
Royal	Hoàng gia
roily	ầm ĩ
rokey	con gà trống
roleo	vai trò
roles	vai trò
rolls	Bánh cuốn
romal	lãng mạn
Romic	Lãng mạn
roods	vỏ bọc
rooed	la hét
roofy	làm thoải mái
roofs	mái nhà
roomy	rộng rãi
rooms	phòng
rooty	gốc rễ
Roots	Rễ
roove	đi lại
ropey	dây thừng
ropes	dây thừng
Rorry	Xe tải
rosal	hoa hồng
rosed	náo loạn
roser	kẻ đánh bại
roses	hoa hồng
rosin	nhựa thông
rotas	thối rữa
rotch	thối rữa
rotes	lễ vật
rotge	thối rữa
rotls	thối rữa
rotor	rôto
rotte	thối rữa
rough	gồ ghề
rouky	khó chịu
round	vòng
roups	nhóm
rouse	đánh thức
roust	ầm ầm
route	tuyến đường
routs	đường đi
roved	lưu động
roven	quay cuồng
roves	lang thang
rovet	đinh tán
rowdy	om sòm
rowed	chèo thuyền
rowel	chèo thuyền
rower	người chèo thuyền
rowet	chèo thuyền
rowte	chèo thuyền
rowth	ồn ào
rowty	ồn ào
rrhea	bệnh rục rịch
ruana	kỳ nhông
rubes	chà xát
Rubin	Cha vao
ruble	đồng rúp
rubor	người xoa bóp
rucky	xui xẻo
rucks	đô la
Ruddy	Hồng hào
ruers	người cai trị
ruffs	xù lông
Rugby	bóng bầu dục
ruggy	thảm
ruins	tàn tích
ruled	cai trị
ruler	cái thước
Rules	Quy tắc
rumen	dạ cỏ
rumly	ầm ầm
Rumor	Tin đồn
rumpy	thô lỗ
runby	chạy qua
runch	run rẩy
runes	rune
rungs	bậc thang
runny	chảy nước mũi
runsy	khô khan
rural	nông thôn
ruses	hối hả
rushy	ồn ào
rusks	hối hả
rusot	chạy nhanh
russe	vội vã
Rusty	Rỉ sét
rusts	rỉ sét
Rutan	Quả chôm chôm
rutch	tiếng hà lan
Saber	Sabre
Sable	Đen
sably	hiền lành
sabot	kẻ phá hoại
SABRE	SABER
Sacks	Bao tải
sacre	thánh tích
sacry	thánh tích
sades	buồn
sadhe	Sadhe
sadic	buồn bã
sadis	Sadis
sadly	thật đáng buồn
safer	an toàn hơn
safes	thật an toàn
sages	hiền nhân
saggy	chảy xệ
saids	đã nói
Sayed	Đã nói
saify	sai lầm
sails	buồm
sayst	người nói
salad	xà lách
sales	doanh số bán hàng
salon	thẩm mỹ viện
salsa	điệu Salsa
salse	nước muối
salty	mặn
salts	muối
salud	lời chào
salve	cứu vớt
salvy	nước muối
samek	giống nhau
samen	giống nhau
sanct	tôn nghiêm
Sands	Cát
sanit	điều dưỡng
Sansk	Tiếng Sansk
Santa	Ông già noel
saple	cây saple
sassy	hỗn láo
satay	sa tế
satin	sa tanh
satis	hài lòng
sauce	Nước xốt
Saucy	Xấc xược
Saudi	Ả-rập Xê-út
Sauks	Nước chấm
sauna	phòng tắm hơi
saury	cá thu đao
saute	áp chảo
saved	lưu lại
savey	tiết kiệm
saver	người tiết kiệm
saves	tiết kiệm
savor	hương thơm
savvy	hiểu
sawed	cưa
sawer	thợ cưa
sawny	có nhiều gai
scabs	vảy cá
scads	cá cóc
scaff	giàn giáo
scags	vảy cá
scald	bỏng nước
scale	tỉ lệ
Scalf	Da đầu
scaly	có vảy
scall	con sò
scalp	da đầu
scalt	bỏng nước
scalx	bỏng nước
SCAME	LỪA ĐẢO
SCAMP	LỪA ĐẢO
scams	lừa đảo
scans	quét
scant	ít ỏi
scape	vật tế thần
scare	sự sợ hãi
scarf	khăn quàng cổ
scary	đáng sợ
scarn	sẹo
scarp	dốc đứng
scars	vết sẹo
scase	cau có
scaul	scul
scaum	cặn bã
scaup	quét rác
scaur	làm sợ hãi
scaut	cái vảy
scawd	đáng sợ
scawl	cái giẻ lau
sceat	quyền trượng
scelp	kêu la
scena	kịch bản
scend	quyền trượng
scene	bối cảnh
scent	hương thơm
Schou	Hội trưởng
Scian	Khoa học viễn tưởng
scind	lừa gạt
scion	cành ghép
Sciot	Khoa học viễn tưởng
sclaw	rau câu
scoad	ăn vạ
scobs	chuồn chuồn
scoff	chế giễu
scoke	mắng mỏ
scold	mắng mỏ
scoon	cái muỗng
scoop	muỗng, xúc
scoot	chuồn đi
scope	phạm vi
score	ghi bàn
scorn	khinh bỉ
scouk	lùng sục
scoup	lùng sục
scour	lùng sục
Scout	Hướng đạo sinh
scove	đi lướt qua
scowl	cau có
scows	quét
scrab	con bọ hung
scrae	bỏ đi
scrag	sự nguệch ngoạc
scray	đánh lạc hướng
SCRAM	LỪA ĐẢO
scrap	sắt vụn
scrat	vết xước
scraw	nguệch ngoạc
scree	sàng lọc
screw	Đinh ốc
scrim	kịch bản
scrip	kịch bản
scrit	vụn vặt
scrog	con lừa
scrow	cau có
scrub	cọ rửa
scrum	cợt nhả
scuff	xô xát
sculk	điêu khắc
sculp	điêu khắc
scult	lừa gạt
scums	đồ cặn bã
scurf	lướt ván
scute	dò xét
seals	con dấu
seamy	ướt át
seams	đường nối
seats	ghế ngồi
seave	đi biển
seavy	nước biển
sebum	bã nhờn
secre	bí mật
sects	giáo phái
sedat	thuốc mê
sedge	cói
sedgy	quyến rũ
Sedum	Thủy bồn thảo
seech	tìm kiếm
seedy	có nhiều hạt
seeds	hạt giống
seege	tìm kiếm
seeks	tìm kiếm
Seely	Nghiêm túc
seems	hình như
seenu	sawu
seepy	thấm
seeps	thấm
seers	tiên kiến
segue	giả mạo
seige	màu be
seise	ngồi yên
seism	địa chấn
seize	nắm bắt
selfs	bản thân
Sells	Bán hàng
semen	tinh dịch
semic	dấu chấm phẩy
semis	bán nguyệt
sends	gửi
sense	ý nghĩa
sepad	lá đài
sepal	đài hoa
sepia	nâu đỏ
sepic	nâu đỏ
septa	vách ngăn
septs	đài hoa
serfs	nông nô
serow	sơn dương
Serra	cái cưa
serum	huyết thanh
serut	con rắn
serve	giao banh
setup	cài đặt
seven	bảy
sever	cắt đứt
sewed	may
Sewel	Ngọc
sewen	may vá
sewer	cống
sexed	quan hệ tình dục
sexes	giới tính
sexly	tình dục
sexts	giới tính
sfree	miễn phí
shack	lán
shade	bóng râm
shady	râm
shads	bóng râm
shaft	trục
shags	tóc giả
shake	lắc
shaky	lung lay
Shaks	Lắc
shale	đá phiến sét
shaly	xấu hổ
shall	nên
shame	xấu hổ
Shang	Thương
Shank	Chân
SHAPE	HÌNH DẠNG
shaps	khuôn hình
shard	mảnh vỡ
share	đăng lại
shark	cá mập
sharn	Sharn
Sharp	Nhọn
shaup	sự lộn xộn
shave	cạo râu
shawy	khăn choàng
shawl	khăn choàng
shawm	khăn choàng
shaws	người cạo râu
sheaf	bó lá
sheal	vỏ bọc
sheat	vỏ bọc
Sheds	Nhà đổ
shedu	đổ ra
sheep	con cừu
sheer	tuyệt đối
sheet	tờ giấy
shelf	cái kệ
Shell	Vỏ bọc
shewn	xẻ thịt
shews	vỏ cây
shyam	nhút nhát
shick	chết tiệt
shide	trốn tránh
shied	xấu hổ
shyer	nhút nhát
shift	sự thay đổi
shilf	quỷ sứ
shily	lém lỉnh
shyly	bẽn lẽn
shill	cò mồi
shims	miếng chêm
shine	chiếu sáng
shiny	sáng bóng
shins	ống chân
ships	tàu thuyền
Shirk	Trốn tránh
shirr	trốn tránh
shirt	áo sơ mi
shish	chết tiệt
shits	khốn nạn
shive	bỏ đi
shivy	rùng mình
shoad	giày dép
shoal	bãi cạn
shock	sốc
shode	đi dạo
shoed	xô đẩy
shoer	người mua sắm
shoes	đôi giày
shogs	giày dép
shole	giày dép
shone	tỏa sáng
shood	bắn súng
shook	rung chuyển
shoop	xô đẩy
shoot	bắn
shops	cửa hàng
Shore	Bờ biển
shorn	rút ngắn
Short	Ngắn
shots	cú đánh
shout	hét lên
shove	xô
showd	trình diễn
showy	sặc sỡ
shown	cho xem
shows	trình diễn
shrab	tiếng kêu réo rắt
shrag	nhún vai
shrap	mảnh vụn
shred	cắt nhỏ
shrew	chuột chù
shrip	réo rắt
shrub	cây bụi
shrug	nhún vai
shuck	xúi quẩy
shuff	xáo trộn
shuln	xa lánh
shuls	rùng mình
shuns	tránh xa
shush	im lặng
Shute	Tắt tiếng
shuts	tắt đi
sybow	ống tiêm
sicko	bệnh hoạn
sicks	bịnh
sicle	vết thương
sided	đứng về phía
sides	hai bên
sidle	đi qua một bên
siege	bao vây
sieve	sàng
sievy	bao vây
sifts	rây
sighs	thở dài
sight	thị giác
sigil	dấu hiệu
Signy	Đáng yêu
signs	dấu hiệu
sikhs	người sikh
silky	mướt
silks	lụa
silly	điên
sills	ngưỡng cửa
silos	hầm chứa
silty	phù sa
silts	lụa
simps	đơn giản
simul	mô phỏng
since	từ
synch	đồng bộ
syncs	đồng bộ
sinew	dây gân
sings	hát
sinky	chìm đắm
sinks	chìm
synod	thượng hội đồng
Sinus	Xoang
siped	nhấm nháp
sired	giống đực
Siren	Còi báo động
sires	đực giống
sirup	thưa ngài
syrup	xi-rô
sises	tiếng ồn ào
sitch	ngồi
sited	ngồi
sites	các trang web
sithe	ngồi
situp	ngôi dậy
sixer	sáu người
sixte	sáute
sixth	thứ sáu
sixty	sáu mươi
sized	có kích thước
sizes	kích thước
skail	trượt băng
skate	giày trượt băng
skats	giày trượt băng
skean	xiên
skeed	xiên
skeeg	xiên
skeel	xiên
skeen	xiên
skeer	xiên
skeet	cái xiên
skegs	xiên
skeif	xiên
skein	con quay
skelf	bản thân
skelp	trượt tuyết
skemp	xiên
skeps	xiên
skere	xiên
skers	người trượt tuyết
skete	trượt băng nghệ thuật
skewy	xiên
skewl	xiên
skews	xiên que
skids	đường trượt
skied	trượt tuyết
skyed	bầu trời
Skier	Người trợt tuyết
skies	bầu trời
skift	nhanh nhẹn
skiis	người trượt tuyết
Skill	Kỹ năng
skime	trượt ván
skimp	thiếu vải
skink	thằn lằn bóng
skins	da
skips	bỏ qua
skirl	kêu
skirp	cái váy
skirt	váy
skite	trượt ván
skits	tiểu phẩm
skive	trượt ván
skiwy	trượt tuyết
skout	trượt băng
skull	đầu lâu
skunk	chồn hôi
skuse	áo choàng
slabs	phiến đá
slags	đồ ăn mòn
slain	bị giết
slays	sự chậm trễ
slait	nô lệ
slake	chém gió
slaky	lười biếng
slams	đóng sầm lại
slang	tiếng lóng
slank	trượt dốc
slant	xiên
slape	cái tát
slaps	tát
slare	nói lảm nhảm
slart	nói xấu
slash	gạch chéo
slate	đá phiến
slath	lời nguyền rủa
slaty	ăn mòn
slats	thanh gỗ
slaum	nô lệ
Slave	Nô lệ
sleck	cái đần độn
sleds	xe trượt tuyết
sleek	trơn
Sleep	Ngủ
sleer	đẹp hơn
sleet	mưa đá
sleys	xe trượt tuyết
Slemp	Mảnh khảnh
slent	nói lảm nhảm
slept	đã ngủ
slete	lém lỉnh
slews	xe trượt tuyết
slice	lát cắt
slich	chất nhờn
slick	bóng bẩy
slide	trượt
slyer	kẻ ranh mãnh
slily	mảnh mai
slyly	ranh mãnh
slime	chất nhờn
slimy	nhầy nhụa
sling	treo lên
slink	lỉnh đi
slipe	làm trơn
slips	trượt
slipt	trượt chân
slirt	ăn vụng
slits	khe hở
slive	vết trượt
sloat	lười biếng
slobs	lười biếng
slock	khóa chặt
sloes	lười biếng
sloid	lười biếng
sloke	lười biếng
sloom	lười biếng
sloot	lười biếng
slope	dốc
slopy	luộm thuộm
slosh	lười biếng
slote	lười biếng
sloth	Sự lười biếng
slots	khe cắm
slour	bùn đất
slows	chậm lại
slued	trì trệ
slugs	sên
sluit	ống cống
Slump	Sụt giảm
slums	khu ổ chuột
slung	trượt
slunk	lười biếng
slurb	khu ổ chuột
slurp	xì xụp
slurs	nói xấu
slush	trầm mặc
sluts	đồ đĩ
smack	đập
Small	Nhỏ
smalt	pha lê xanh
smarm	cười khẩy
Smart	Thông minh
smash	đập vỡ
smaze	hơi men
smear	bôi nhọ
smeek	bôi nhọ
smeer	người bôi bẩn
smell	mùi
smelt	có mùi
smeth	bôi bẩn
smews	bôi nhọ
smile	mỉm cười
smily	mặt cười
SMILS	NỤ CƯỜI
smirk	nhếch mép
smite	đánh lén
Smith	thợ rèn
Smitt	Chuyển tiền
Smock	Khói
smogs	sương khói
Smoke	Khói
smoky	có khói
smook	sương khói
Smoot	Làm mịn
smore	hôi hơn
smote	sương khói
smous	có mùi
smout	sương khói
smurr	người ăn cắp vặt
smuse	hun khói
smush	chảy nước miếng
snaff	khặc khặc
snail	ốc sên
snake	con rắn
snaky	cáu kỉnh
snare	cạm bẫy
snary	lanh lẹ
snarl	tiếng gầm gừ
snash	búng tay
snast	rắn chắc
snead	lén lút
sneak	đánh lén
sneap	quay lén
sneck	đánh lén
Sneed	Quay lén
sneer	chế nhạo
snibs	khịt mũi
snick	khịt mũi
snide	bắn tỉa
snies	bắn tỉa
sniff	bị nghẹt mũi
snift	vết cắt
snigs	khịt mũi
snipe	bắn tỉa
snipy	ăn trộm
snips	ảnh cắt
snirt	khịt mũi
snits	khạc nhổ
snivy	cười khẩy
snobs	kẻ ăn trộm
snock	ngáy
snoek	rình mò
snogs	ngáy khò khò
snoke	rình mò
snood	ngủ ngáy
snoop	rình mò
snoot	MU ~ i
snore	ngủ ngáy
snork	ống thở
snort	khịt mũi
snots	ngáy
snout	mõm
snowy	có tuyết rơi
snowk	tuyết rơi
snowl	tuyết
snows	tuyết
snubs	khờ khạo
snuck	lẻn
snuff	hít đất
snurp	hít hà
snurt	hắt hủi
soaky	ướt đẫm
soaks	ngâm nước
soapi	xà phòng
soapy	xà phòng
soaps	xà phòng
soary	ốm yếu
soars	bay lên
sobby	ốm yếu
sober	tỉnh táo
socii	xã hội
socky	ướt sũng
socks	vớ
sodas	nước sô-đa
Soddy	Buồn cười
sodic	buồn tẻ
sofar	cho đến nay
sofas	ghế sofa
Sofer	Mềm hơn
softy	mềm mại
soget	cho nên
soggy	sũng nước
soyas	đậu nành
soign	cai trị
soily	buồn bã
soils	đất
Soyot	Đậu nành
sokes	nức nở
solar	hệ mặt trời
soldi	selli
soldo	sello
soled	có đế
soles	đế
solid	cứng
solos	độc tấu
solve	giải quyết
somet	một số
Somis	Người Somis
songy	song
songs	bài hát
sonly	con trai
sonsy	con trai
sooky	có mùi thơm
sooth	êm dịu
sooty	có mùi hôi
soots	sooc
sophy	ngụy biện
sopor	ngụy biện
soppy	vui vẻ
Sorce	Phù thủy
sorer	tốt hơn
sores	vết loét
sorry	lấy làm tiếc
sorty	sắp xếp
sorts	sắp xếp
sough	chua
souks	Souks
Soule	Linh hồn
souly	linh hồn
souls	linh hồn
SOUND	ÂM THANH
soupy	nước lèo
soups	súp
sourd	chua
soury	chua
sours	mãng cầu xiêm
souse	ngâm trong
South	miền Nam
sowed	gieo
sowel	heo nái
Sower	Người gieo
sowle	heo nái
sowse	gieo hạt
sowte	nái
space	khoảng trống
spack	đánh tráo
spade	thuổng
spaed	thưa thớt
spaer	thợ spa
spail	nhổ nước bọt
Spain	Tây Ban Nha
spake	đánh thức
spall	cơn bão
spank	đánh đòn
spans	nhịp
spare	bổ sung
Spark	Tia lửa
sparm	vũ khí
spasm	co thắt
spave	tha hồ
spawl	sinh sản
spawn	đẻ trứng
speak	nói
speal	đặc biệt
spean	Spean
Spear	Thương
spece	giọng nói
speck	lấm tấm
specs	thông số kỹ thuật
spect	bóng ma
speed	tốc độ
speel	giọng nói
speen	giọng nói
speil	lời nói
speir	giọng nói
spekt	giọng nói
spell	Đánh vần
spelt	đánh vần
spend	dành
spent	dành ra
speos	giọng nói
sperm	tinh trùng
spewy	có lông
spews	phun ra
spice	gia vị
spicy	vị cay
spick	khạc nhổ
spied	do thám
spiel	gai
spies	gián điệp
spiff	gai nhọn
Spike	Mũi nhọn
spiky	có gai
spiks	gai
spill	tràn
spilt	làm đổ
spina	xương sống
spine	xương sống
spiny	có gai
spink	xoay vòng
spins	vòng quay
spire	ngọn lửa
spirt	phun ra
spise	cây spise
spite	cay cú
spits	khạc nhổ
splad	bà chủ
splat	tiếng bắn tung tóe
Split	Tách ra
spoil	chiều hư
spoke	đã nói
spoky	có nhiều bọt
spong	bọt biển
spoof	giả mạo
spook	ma quái
spool	ống chỉ
spoon	cái thìa
Spoor	Trong nhà
spoot	chiến lợi phẩm
spore	bào tử
sport	thể thao
sposh	tiếng lách cách
spots	điểm
spout	vòi
sprad	loang ra
sprag	bong ra
spray	Xịt nước
spret	viết lách
sprew	vặn vít
sprig	thanh niên
sprug	cành cây
spued	dán vào
spumy	bẩn thỉu
spung	quay
spunk	lòng lang dạ thú
spurn	cự tuyệt
spurs	cựa
spurt	phun ra
spute	cây spute
squab	cãi nhau
squad	đội hình
squam	tiếng kêu thảm thiết
squat	ngồi xổm
squeg	kêu ré lên
squet	tiếng kêu
SQUID	MỰC ỐNG
squin	ngồi xổm
squit	ngồi xổm
ssort	sắp xếp
stabs	vết đâm
stack	cây rơm
staff	Nhân Viên
STAGE	SÂN KHẤU
stagy	loang lổ
stags	quân cờ
staid	nghiêm trang
stail	đóng cọc
stain	vết bẩn
stair	cầu thang
stays	ở lại
stake	cổ phần
stale	cũ
Stalk	Rình rập
stall	ngăn cản
stamp	con tem
stand	đứng
stank	bốc mùi hôi thối
stare	nhìn chằm chằm
Stark	Ngay đơ
STARS	NGÔI SAO
start	bắt đầu
starw	sao
stash	cất
State	Tình trạng
stats	số liệu thống kê
stave	cọc
stawn	khoanh vùng
Stead	Ổn định
steak	lát thịt
steal	ăn cắp
steam	hơi nước
steed	chiến mã
Steel	Thép
Steep	Dốc
steer	chỉ đạo
stela	tấm bia
stele	tấm bia
stema	thân cây
stems	thân cây
steps	các bước
stept	con ghẻ
stere	ster
steri	khử trùng
Stern	Nghiêm nghị
stewy	hầm hố
stews	món hầm
stick	dán
styed	tạo kiểu
Stier	Cứng hơn
styes	lẹo
stife	hôi thối
stiff	cứng
stile	cứng nhắc
style	Phong cách
styli	nhà tạo mẫu
Still	Còn
stilt	cà kheo
stimy	hôi thối
stymy	lấm lem
Stine	đá
sting	châm chích
stink	mùi hôi
stint	còn sống
stirk	khuấy động
stivy	hôi thối
stoae	stae
stoai	stai
stoas	khom lưng
stobs	khom lưng
Stock	Cổ phần
stoep	khom lưng
stoff	khom lưng
stogy	ngổn ngang
Stoic	Kiên nhẫn
stoit	khom lưng
stold	xếp lại
stole	ăn trộm
stoma	lỗ khí
stomy	cơ nhị đầu
stomp	dậm chân
Stone	Cục đá
stony	đá
stood	đứng
stoof	khom lưng
stook	nhìn chằm chằm
stool	ghế đẩu
stoop	lưng tôm
stoot	khom lưng
stops	dừng lại
stopt	dừng lại
store	cửa hàng
Story	Câu chuyện
stork	con cò
Storm	Bão
Stout	bia đen
stove	bếp
stows	xếp hàng
strae	đi lạc
strag	đi lạc
stray	đi lạc
stram	đi lạc
strap	dây đeo
straw	Rơm rạ
strew	vằn vện
stria	vân
strid	khô khan
strig	sự cố gắng
strip	dải
stroy	lạc lõng
strow	cọc
strub	cây bụi
strue	sợi dây
strum	gảy đàn
strut	đi khệnh khạng
stubb	mập mạp
stubs	sơ khai
stuck	mắc kẹt
stude	đinh tán
study	nghiên cứu
studs	đinh tán
stuff	vật dụng nhỏ
stump	gốc cây
stung	châm chích
stunk	rác rưởi
stuns	làm choáng váng
stunt	đóng thế
stupa	bảo tháp
sturk	cứng cáp
suant	người kiện cáo
subet	tập con
subst	phụ
sucks	hút
suede	da lộn
suety	ăn ngon
Sugar	Đường
sugat	có đường
suing	kiện
suint	cây bạc hà
suite	Thượng hạng
suits	bộ quần áo
sulky	hờn dỗi
sulks	hờn dỗi
sumph	bể phốt
sumps	bể phốt
sumpt	xa hoa
Sunny	Nhiều nắng
sunns	mặt trời
super	siêu
sural	đạo đức
sured	bị kiện
surer	người chắc chắn
sures	kiện cáo
surfy	dâng lên
surfs	lướt sóng
surge	dâng trào
surgy	nổi sóng
surly	đột ngột
sussy	lém lỉnh
sutor	gia sư
sutra	kinh
sutta	bài kinh
swabs	tăm bông
swack	đánh tráo
swail	chửi thề
sways	lắc lư
swamp	đầm lầy
swank	phô trương
swans	thiên nga
Swaps	Hoán đổi
sward	thề thốt
sware	chửi thề
swarm	họp lại
swash	cuốn vào
swath	lời thề
sweal	mồ hôi
swear	thề
sweat	mồ hôi
Swede	Người Thụy Điển
sweep	quét
sweer	ngọt ngào
Sweet	Kẹo
swego	cục cưng
swell	sưng lên
swelp	nói chuyện phiếm
swelt	căng phồng
swept	quét
SWIFT	NHANH
swile	ruồng rẫy
swimy	bơi lội
swims	bơi lội
swine	heo
swing	lung lay
swipe	vuốt
swipy	vuốt ve
swird	kỳ quặc
swire	chửi thề
swirl	xoáy
Swiss	Thụy Sĩ
swobs	bộ ngực
swoop	sà vào
sword	thanh kiếm
swore	thề
sworn	tuyên thệ
swosh	xoáy
swots	thiên nga
swung	vung vẩy
swure	thề thốt
tabes	tab
tabid	lá cải
table	chiếc bàn
tabog	giả mạo
taboo	điều cấm kỵ
tabus	lá cải
tacet	vòi
tacit	Ngấm ngầm
tacky	dính chặt
tacks	đinh ghim
tacos	bánh tét
tacts	hành vi
taels	lượng
taggy	nói tục
tails	đuôi
tains	lợi nhuận
taint	vết bẩn
taise	thuần hóa
taish	ăn thịt
taked	đánh dấu
taken	Lấy
taker	người thu tiền
takes	nhận
taled	được đánh dấu
taler	người đánh dấu
tales	những câu chuyện
talky	nói nhiều
talks	cuộc nói chuyện
Tally	Kiếm điểm
talus	móng tay
tamed	thuần hóa
tangy	rối rắm
tangs	tang
tanks	xe tăng
Tansy	Cây cúc ngải
tanzy	da ngăm
taped	ghi hình
taper	côn
Tapes	Băng
tapir	heo vòi
tardy	đi trễ
tared	cắt tỉa
tarns	nhựa đường
tarok	khoai môn
taros	khoai môn
tarot	bói bài
tarps	vải dầu
tarry	nhựa đường
tarse	thuộc da
tarty	tiệc tùng
tarts	bánh kem trái cây
tasks	nhiệm vụ
tasse	nếm thử
taste	nếm
tasty	ngon
Tatar	Người Tatar
tater	khoai tây
tatty	rách nát
taunt	chế nhạo
taupe	băng
tauts	căng thẳng
taver	người khai thác
tawed	cắt tỉa
tawer	người cắt cỏ
tawny	có màu nâu
tawsy	có lông
taxed	bị đánh thuế
taxer	người đánh thuế
taxes	thuế
taxir	người đánh thuế
taxis	taxi
taxon	đơn vị phân loại
taxor	người đánh thuế
tazze	uống rượu
Teach	Dạy
teaey	nước trà
teaer	người pha trà
Teays	Trò đùa
teaks	gỗ tếch
teals	màu xanh mòng két
teams	đội
teary	đẫm nước mắt
tears	những giọt nước mắt
tease	trêu chọc
teasy	khó chịu
teaty	chảy nước miếng
teats	núm vú
teave	xé nát
teaze	nước trà
techy	kỹ thuật
tecum	manh tràng
Teece	Thiếu niên
teems	rất nhiều
Teena	Thiếu niên
teeny	nhỏ xíu
teens	thiếu niên
teest	sự nhõng nhẽo
teeth	hàm răng
teety	ngoan cường
teise	trêu chọc
teleg	điện báo
telly	Truyền Hình
tells	kể
tellt	Nói với t
Tempe	Ôn đới
temps	tạm thời
tempt	cám dỗ
tendo	có xu hướng
tends	xu hướng
tenet	nguyên lý
tenon	mộng
tenor	giọng nam cao
tense	bẩn quá
tenth	thứ mười
tents	lều trại
tepid	ấm
terce	mối quan hệ
terms	điều kiện
terns	Nhạn biển
terse	ngắn gọn
testy	cứng rắn
tests	bài kiểm tra
tetel	cây uốn ván
teths	sâu bướm
tewel	viên ngọc
texts	văn bản
Thach	Thạch
Thais	Người thái
thank	cảm tạ
thatd	cái đó
thats	đó là
thawy	tan băng
thawn	tan băng
thaws	tan băng
theek	hiền lành
theft	trộm cắp
theyd	chúng
their	của chúng
theme	chủ đề
there	ở đó
therm	nhiệt độ
these	này
thete	sở trường
thews	dây gân
thick	đặc
thigh	đùi
thilk	con bọ phấn
thyme	xạ hương
thymy	cỏ xạ hương
thyms	cỏ xạ hương
thine	của bạn
thing	Điều
think	nghĩ
thins	mỏng
third	ngày thứ ba
thirt	cái thúi
thisn	cái này
Thorn	gai
those	những, cái đó
thrap	thúi
THREE	BA
threw	ném
thrip	bọ trĩ
throb	nhói lên
throe	đau nhói
throw	ném
thrum	đánh trống lảng
thuds	tiếng thịch
thugs	côn đồ
thumb	ngón tay cái
thump	tiếng đập mạnh
thund	sấm sét
thung	chong chóng
thunk	đánh mạnh
thurm	tiếng ồn ào
Thurs	Thứ năm
thurt	thút thít
tiara	vương miện
tibby	tiều tụy
tibey	ngăn nắp
Tibet	Tây tạng
tibia	xương chày
ticer	người pha tạp chất
Tyche	Vải lanh
ticky	nhột nhạt
ticks	tích tắc
tidal	thủy triều
tiddy	ngăn nắp
tided	tô màu
tides	thủy triều
tyees	ty cà phê
tiers	bậc
tiffs	tiff
tiger	con hổ
tight	chặt
tigon	Hổ sư
tying	buộc
tikis	tiki
tilak	Tilak
tilde	dấu ngã
tiled	lát gạch
tiles	gạch
Tilli	Cho đến khi tôi
tills	dấu tích
tilth	cho đến nay
tilty	người nghiêng
tilts	nghiêng
timar	thời gian
timed	hẹn giờ
timer	hẹn giờ
times	lần
timet	thời gian
timid	nhút nhát
Timms	Thời gian
Timne	Thời gian
tinea	nấm da đầu
tined	tráng men
tyned	buộc lại
tines	kim cương
tinge	nhuốm màu
tinny	nhỏ xíu
tinsy	giấy bạc
tints	sắc thái
typal	đánh máy
typed	đã đánh máy
typey	kiểu chữ
typer	người đánh máy
types	các loại
typic	điển hình
tipis	tiền boa
tipit	tiền boa
typos	lỗi chính tả
tippy	rôm rả
tipsy	say
tipup	tiền boa
tired	mệt mỏi
tyred	buộc chặt
tirer	người xếp hạng
tires	lốp xe
tyres	lốp xe
TIRKS	LỐP
tyste	bạo lực
tithe	phần mười
title	chức vụ
Titus	Tít
tiver	thợ làm cỏ
Tizes	Kích cỡ
tizzy	râm ran
toady	ngu ngốc
toads	con cóc
toast	nướng
Tobye	Tạm biệt
today	hôm nay
tofts	xe nâng
toged	rèn giũa
togue	lừa dối
toher	đến cô ấy
toyed	đùa giỡn
toils	làm việc
toyon	đồ chơi
toyos	đồ chơi
toise	tôi sẽ
toist	xé toạc
token	mã thông báo
toldo	đã nói
tolls	phí cầu đường
toman	người lái xe
tombs	lăng mộ
tonal	âm sắc
toned	săn chắc
toner	mực toner
tones	âm
tongs	kẹp
tonic	thuốc bổ
Tonie	Tư chôi
tonne	tấn
tools	công cụ
Toone	Đến một
tooth	răng
toots	dấu chấm
toped	phủ lên trên
topee	đi tiểu
topic	đề tài
topsl	ngọn
torch	đèn pin
tored	săn chắc
Torry	Xe tải
torso	thân mình
torta	rùa bò
torts	áo sơ mi
Torun	Chạy
torus	hình xuyến
toshy	xấu hổ
tossy	quăng quật
total	toàn bộ
totem	vật tổ
totty	toàn bộ
totum	tổng cộng
touch	chạm
tough	khó
tould	phải
Tound	Thắt chặt
Tours	Chuyến tham quan
touse	sử dụng
toust	hành hạ
touts	chào hàng
tovet	ham muốn
towed	kéo
towel	khăn tắm
Tower	Tòa tháp
towns	thị trấn
towsy	dai dẳng
toxic	chất độc
toxin	độc tố
toxon	độc tố
Trace	Dấu vết
track	theo dõi
trade	buôn bán
trady	khéo léo
trail	đường mòn
train	xe lửa
trays	khay
trait	đặc điểm
trama	đau mắt
tramp	kẻ lang thang
trams	xe điện
trank	đường mòn
trans	Dịch
traps	bẫy
trapt	đi bộ
trash	rác
trasy	rác rưởi
trave	đi qua
trawl	lưới kéo
tread	bước đi
treas	kho bạc
TREAT	ĐÃI
treey	nhiều cây
treen	màu xanh lá cây
trees	cây
treks	đi bộ
trend	xu hướng
trets	chuyến đi
Triad	Bộ ba
trial	sự thử nghiệm
tribe	bộ lạc
trick	bí quyết, Thuật, mẹo
Tryck	Thử
tried	cố gắng
tries	cố gắng
trigs	vấp ngã
trike	xe ba gác
trims	đồ trang trí
trink	đồ lặt vặt
Tryon	Thử quần áo
trios	bộ ba
tripe	lòng
tripy	gấp ba lần
trips	những chuyến đi
tryst	người thử
trite	sáo mòn
trock	lừa gạt
TROFF	GIAO LƯU
troft	bước đi
troll	chơi khăm
tronk	trò đùa
troop	đoàn quân
tropy	nhiệt đới
trots	trót lọt
troue	hát rong
Troup	Nhóm
Trout	Cá hồi
trouv	hát rong
trows	ném
truce	đình chiến
truck	xe tải
truer	trốn học
truly	thực sự
trull	thân tàu
trump	kèn
trunk	Thân cây
truss	giàn
Trust	Tin tưởng
Truth	Sự thật
tsars	sa hoàng
tuant	dây quấn
tuarn	sợi
tubal	ống dẫn trứng
tubby	quần áo
tuber	củ
tubes	ống
tubig	bồn tắm
tucks	quần lót
tugui	kéo co
tules	bánh tules
tulip	hoa tulip
Tulle	Vải tuyn
Tumer	Khối u
tumid	sưng lên
tummy	nằm sấp
tumor	khối u
tumps	đống
Tunas	Cá ngừ
tuned	điều chỉnh
tuner	bộ chỉnh
tunes	giai điệu
tunic	áo dài
Turbo	bộ tăng áp
turfy	làm biến đổi
turgy	hỗn loạn
turks	thổ nhĩ kỳ
Turne	Quay đầu
turns	lần lượt
turps	củ cải
turvy	lộn xộn
tushy	dày cộp
tusky	dày cộp
tusks	ngà voi
Tussy	Âm hộ
tutor	gia sư
Twain	Hai
twank	xoắn
twant	vặn vẹo
twats	đôi
tweak	chỉnh sửa
tween	tuổi mười bảy
tweet	tiếng riu ríu
twerp	kẻ phiên phưc
twice	hai lần
twick	vặn vẹo
twigs	cành cây
twill	đan chéo
twilt	sự bẻ cong
twine	quanh co
twiny	sinh đôi
twink	lấp lánh
Twins	Sinh đôi
twire	xoắn
twirk	nhếch mép
twirl	xoay vòng
twirp	xoay vòng
twist	xoắn
twits	khúc chiết
twoes	hai cái
tzars	răng cưa
Udele	Đàn udele
ulcer	vết loét
ulent	loét
ulmic	loét
ultra	cực kỳ
umble	nhanh nhẹn
Umbra	Vong linh
umbre	những chiếc ô
umped	không bị cản trở
umpty	khiêm tốn
unact	cởi mở
unadd	undd
unapt	không thích
unare	không có tuổi
unary	một ngôi
unarm	bỏ vũ khí
unaus	unus
unbag	mở túi
unbar	bỏ thanh
unbed	không có giường
unbid	không trả giá
unbit	bỏ ghim
unbog	tháo gỡ
unbow	mở ra
unbox	mở hộp
unbud	tháo ra
uncap	mở nắp
UNCLE	CHÚ
uncoy	thô kệch
uncos	unos
uncow	cởi bỏ
uncus	bác bỏ
uncut	chưa cắt
under	Dưới
undid	mở nắp
undye	không nhuộm
undig	cởi quần áo
undog	gỡ xuống
undon	gỡ xuống
undub	gỡ bỏ
undue	Thái quá
undug	cởi quần áo
unfar	mở ra
unfed	mở ra
unfit	không thích hợp
unfix	tháo gỡ
unfur	mở ra
ungag	vô hiệu
unget	ung dung
ungod	ung dung
ungot	không có
unhad	không vui
unhap	không vui
unhat	mở ra
unhex	không có gì
unhip	bỏ tàu
unhit	làm hư
unhot	mở ra
unice	đoàn kết
unify	thống nhất
Union	liên hiệp
unism	thống nhất
unite	đoàn kết
Unity	Đoàn kết
units	các đơn vị
unjam	cởi truồng
unked	không ngoan
unkey	mở khóa
unken	vô tình
unket	không ngoan
unkid	không ngoan
unkin	xấu xa
unlay	mở ra
unlap	bung ra
unlaw	trái luật
unlax	làm sạch
unlet	tháo ra
unlid	mở ra
unlie	tháo gỡ
unlit	không có đèn
unmad	cởi trần
unmet	chưa được đáp ứng
unmew	mở ra
unmix	không trộn lẫn
unnet	bỏ mạng
unnew	chưa biết
unode	mở ra
unoil	mở ra
unown	không xác định
unpay	bỏ trả
unpen	mở ra
unpin	bỏ ghim
unpot	tháo ra
unput	tháo ra
unrid	làm khô
unrig	tháo ra
unrip	tháo ra
unrow	bung ra
unrun	tháo chạy
unsad	cởi ra
unsay	không trả lời
unsee	không nhìn thấy
unset	không đặt
unsew	tháo ra
unshy	không có tiếng
unsin	bỏ ghim
unsly	không đáng tin cậy
unson	bỏ đi
unsty	không đủ
unsun	bỏ chạy
untap	mở ra
untar	cởi ra
untax	tẩy lông
untie	cởi trói
until	cho đến khi
untin	cởi trói
untop	mở ra
unurn	mở ra
unuse	không sử dụng
unwas	không có
unwax	không có sáp
unweb	bỏ mạng
unwed	không muốn
unwet	mở ra
unwig	không cẩn thận
unwit	không cho phép
unwon	không có
unwry	chưa khô
unzip	giải nén
uparm	trang bị
upbid	cao hơn
upbye	tạm biệt
upbow	nâng lên
upbuy	mua sắm
upcry	phấn khởi
upcut	cắt xén
updry	cập nhật
upend	bỏ ra
upfly	đom đóm
upget	Lên nhận được
upher	người nâng lên
uplay	lớp phủ
upleg	sự cố gắng
uplit	sáng sủa
upped	nâng lên
upper	phía trên
uprid	khó khăn
uprip	đi lên
uprun	chạy lên
upset	khó chịu
upsit	nâng lên
upsun	upun
upsup	up up
upway	đi lên
upwax	sáp ong
Urban	Đô thị
urbia	chứng sợ hãi
urbic	ham ăn
Urdar	Tiếng Urdar
urdee	sự thúc giục
Urdur	Tiếng Urdur
ureas	urê
ureic	urê
ureid	urê
urged	thúc giục
urger	người thúc giục
urges	thúc giục
Urias	Nước tiểu
Urien	Nước tiểu
Uriia	Nước tiểu
urine	nước tiểu
urman	người đàn ông ur
Urmia	Chứng đái máu
urous	xấu xí
usage	sử dụng
usant	sử dụng
usent	sử dụng
users	người dùng
using	sử dụng
usual	thường
usure	sử dụng
usury	cho vay nặng lãi
usurp	chiếm đoạt
utchy	vô cùng
utees	tử cung
utend	làm theo ý mình
uteri	tử cung
utero	tử cung
utile	vô ích
uvate	nâng cấp
uveal	bầu trời
Uzbeg	Tiếng Uzbeg
Uzbek	Tiếng Uzbek
vacuo	chân không
vague	mơ hồ
vagus	phế vị
vails	thùng rượu
valet	người hầu
valew	lễ tình nhân
valid	có hiệu lực
valor	dũng cảm
value	giá trị
valve	van
vanes	cánh gạt
vapid	bốc hơi
vapor	hơi nước
varan	kỳ đà
varas	kỳ đà
vases	lọ hoa
vasty	bao la
vasts	vast
vault	kho tiền
veals	khăn che mặt
Vedas	Kinh Vedas
Vedic	Vệ Đà
veeps	tiếng veeps
vegan	thuần chay
veils	mạng che mặt
veiny	có vân
veins	tĩnh mạch
velal	vật ngựa
venal	dể hối lộ
vends	tự động
venge	báo thù
venom	nọc độc
vents	lỗ thông hơi
venue	hội họp
Venus	sao Kim
verbs	động từ
verry	tươi vui
versa	ngược lại
verse	thơ
verso	trang sau
verty	xanh tươi
verus	chóng mặt
Vesty	Uy nghiêm
vests	áo gi lê
vetch	cây đậu tằm
vetus	phủ quyết
vexed	bực bội
vexer	làm phật lòng
vexes	phật ý
vexil	làm phật lòng
vials	Lọ
viand	dây leo
vibes	đàn tăng dung
vicar	cha sở
viced	nạn nhân
vices	tệ nạn
video	băng hình
viewy	quang cảnh
views	lượt xem
vigil	cảnh giác
Vigor	Sức sống
vying	tranh giành
Villa	Biệt thự
villi	nhung mao
vills	nhân vật phản diện
vinea	cây nho
vined	giành giật
vinew	cây nho
vinyl	nhựa vinyl
viols	vi phạm
viral	Lan tỏa
vires	quyền lực
Virgo	Xử Nữ
virtu	điêu luyện
virus	vi-rút
visas	thị thực
vised	nhìn thấy
vises	tầm nhìn
visit	chuyến thăm
visor	tấm che mặt
vitae	sơ yếu lý lịch
vital	thiết yếu
vitro	ống nghiệm
vivid	sống động
vocal	giọng hát
voces	ơn gọi
vodka	rượu vodka
vodum	rượu vodum
vogue	thịnh hành
voice	giọng nói
voids	khoảng trống
voila	thì đấy
voles	chuột đồng
volow	vồ vập
volts	vôn
vomer	lá mía
vomit	nôn mửa
voted	bình chọn
voter	cử tri
votes	phiếu bầu
vouch	xác nhận
vouge	xác nhận
Vouli	Phiếu quà tặng
voust	tiếng vo ve
vowed	thề
Vowel	Nguyên âm
vulva	âm môn
wacky	kỳ quặc
waded	lội nước
wades	lội nước
wadge	cái giẻ lau
waffs	waff
waged	tiến hành
Wager	Cuộc đánh cá
wages	tiền công
waggy	uốn éo
Wagon	Toa xe
waifs	miễn trừ
waily	miễn cưỡng
wails	than vãn
waird	Waird
wairs	từ bỏ
waise	dao động
waist	thắt lưng
waits	chờ đợi
waive	từ bỏ
waked	đã thức dậy
waken	kêu
wakes	thức dậy
waled	đi bộ
Wales	Xứ Wales
walks	đi dạo
Walls	Tường
walth	sự giàu có
wames	lửa
wands	cây đũa phép
waned	lu mờ
wanes	tàn lụi
wanky	yếu ớt
wanna	muốn
wanty	ham muốn
wants	muốn
warch	sợi dây
wards	phường
wared	chiến đấu
warer	kho hàng
wares	đồ gốm sứ
warly	mơ hồ
Warms	Làm ấm
warns	cảnh báo
warnt	cảnh báo
warps	cong vênh
warse	tàn lụi
warty	tàn nhẫn
warts	mụn cóc
warve	chiến tranh
Wasat	Đã ở
washy	bẩn thỉu
wasnt	đã không
waspy	cây thuốc phiện
Wasps	Ong bắp cày
waste	rác thải
wasty	gầy
wasts	rác thải
watap	wap
watch	đồng hồ đeo tay
water	nước
Waugh	Khà khà
waved	vẫy tay
waver	lung lay
WAVES	SÓNG
waxed	sáp
waxer	thợ tẩy lông
waxes	sáp
weaky	yếu đuối
Weaks	Weak
weals	ăn mòn
weans	người cai sữa
Weare	Chúng tôi là
weary	mệt mỏi
wears	mặc
weave	dệt
wedge	cái nêm
wedgy	đám cưới
weedy	cỏ dại
weeds	cỏ dại
Weeks	Tuần
weens	mọt
weent	cỏ dại
weepy	khóc
weeps	khóc
weesh	cỏ dại
weest	mệt mỏi
weety	mệt mỏi
weeze	làm điên cuồng
wefty	giàu có
wefts	sợi ngang
weigh	cân
weird	kỳ dị
weirs	đập nước
weism	chủ nghĩa xã hội
welds	mối hàn
welly	lành lặn
Welsh	người xứ Wales
welts	mối hàn
wends	cỏ dại
weren	wasn
westy	tây
wests	áo choàng
wetly	ướt át
wevet	thèm thuồng
whack	cái gì
Whale	Cá voi
whaly	kỳ quặc
Whall	Cá voi
whalp	cá voi
whame	cái gì vậy
whamp	cá voi
whams	những gì
whand	thuận tay
whank	cái gì
whaps	có lẽ
whare	cái gì vậy
wharf	cầu cảng
wharp	cái gì
whart	cái gì
whase	cái gì vậy
whata	cái gì vậy
whatd	cái gì
whats	cái gì vậy
whaup	chuyện gì vậy
whaur	cá voi
wheal	váng sữa
wheam	váng sữa
wheat	lúa mì
wheel	bánh xe
wheep	khò khè
wheft	đường cong
wheys	váng sữa
whelk	váng sữa
whelp	đánh lừa
where	ở đâu
whewl	tiếng vo ve
whews	bánh xe
whewt	khò khè
which	cái mà
whids	roi
whiff	huýt sáo
whift	roi vọt
whigs	roi vọt
while	trong khi
whilk	đánh trống lảng
whill	đánh trống lảng
whils	đánh trống lảng
whims	ý tưởng bất chợt
whine	rên rỉ
whiny	nhõng nhẽo
whins	tiếng rên rỉ
whips	roi da
whipt	quất
whirl	quay cuồng
whirr	tiếng vù vù
whirs	đánh trắng
whish	quất
whisk	đánh trứng
whisp	thì thầm
whiss	tiếng rít
whist	huýt sáo
White	trắng
whity	nhõng nhẽo
whits	ý kiến
whizz	vù vù
whoas	ai nhu
whole	trọn
wholl	ai sẽ
whomp	con điếm
whone	con điếm
whoof	cái gì
whoop	vù vù
whoot	con điếm
whops	con điếm
whore	con điếm
whory	con điếm
whorl	tiếng vù vù
whort	con điếm
whose	của ai
whoso	cũng vậy
whsle	bán buôn
wicky	lém lỉnh
widdy	góa bụa
widen	mở rộng
wider	rộng hơn
wides	rộng rãi
widow	Góa phụ
width	chiều rộng
wield	vận dụng
wiggy	tóc giả
wilds	hoang dã
wiled	héo hon
wyled	đi lộn xộn
Willy	Sẽ y
Wills	Di chúc
Wilts	Héo
wimps	khăn lau
wince	nhăn
winch	tay quay
Windy	Co gio
winds	gió
wined	héo hon
wines	rượu vang
wingy	có cánh
wings	cánh
winks	nháy mắt
winly	thắng lợi
winze	ngủ gật
wiped	lau
wiper	khăn lau
wipes	khăn lau
wired	có dây
wires	Dây điện
wised	lau
wisen	khôn ngoan
wiser	khôn ngoan hơn
wises	khôn ngoan
wisha	khôn ngoan
wishy	khôn ngoan
wisht	điều ước
wispy	nhăn nhó
witch	phù thủy
wited	héo úa
wyted	làm việc
witen	làm héo
wites	trí thông minh
Witha	Với một
withe	mụ mụ
withy	mang theo
Witty	Dí dỏm
wived	quăn queo
wives	các bà vợ
wizen	nhăn nheo
wizes	gió bấc
wlity	sức mạnh
woady	tiếng kêu thảm thiết
woads	gâu gâu
wodge	tránh né
wodgy	lém lỉnh
woful	thảm hại
woken	thức dậy
woldy	kỳ quặc
Wolfy	Vui vẻ
wolfs	chó sói
wolly	quái đản
wolve	chó sói
woman	đàn bà
wombs	tử cung
women	đàn bà
wonky	rung rinh
wonks	nháy mắt
wonts	tai ương
Woody	thân gỗ
Woods	gỗ
wooed	tán thành
wooer	người nói chuyện
woofy	tán tỉnh
woofs	gâu gâu
woold	gâu gâu
wooly	len lén
wools	len
woomp	len lỏi
woons	len
woops	gâu gâu
woosh	gâu gâu
woozy	khờ khạo
wopsy	khám nghiệm
wordy	dài dòng
words	từ ngữ
worky	chăm chỉ
works	làm
world	thế giới
wormy	sâu bọ
Worms	Giun
worry	lo
worse	tệ hơn
worst	tồi tệ nhất
Worth	Đáng giá
would	sẽ
wound	vết thương
woven	dệt
wowed	kinh ngạc
wrack	bọc lại
wramp	bọc lại
wrang	sự quấn quít
wraps	kết thúc
wrapt	bao bọc
wrast	bao bọc
Wrath	Cơn thịnh nộ
wrawl	quấn lấy nhau
wreak	làm hỏng
wreat	vòng hoa
wreck	xác tàu
wrest	đấu vật
wrick	vặn vẹo
wried	nhăn nhó
wrier	cổ tay
wryer	người vắt vẻo
wries	đồ chiên
wryly	nhăn nhó
wring	vặn
wrist	cổ tay
write	viết
writh	luồn lách
writs	văn vật
wrive	cổ tay
wroke	bơi lội
wrong	Sai lầm
wrote	đã viết
wrung	uốn éo
wudge	đi lang thang
Wuhan	Vũ Hán
wurly	sợ hãi
zebra	ngựa rằn
zeism	chủ nghĩa nhiệt thành
Zenas	Ngựa vằn
zeros	số không
ziffs	khóa kéo
zincs	kẽm
zippy	kéo dài
zoism	chủ nghĩa động vật
zonal	địa đới
zoned	khoanh vùng
zones	khu
zooms	phóng to
zoons	vườn thú
